region_id,C11_75_79_N_mar_M,C11_75_79_N_mar_F,C11_75_79_T_M,C11_75_79_T_F,C11_75_79_T_P,C11_80_84_Mar_RegM_M,C11_80_84_Mar_RegM_F,C11_80_84_Mar_DFM_M,C11_80_84_Mar_DFM_F,C11_80_84_N_mar_M,C11_80_84_N_mar_F,C11_80_84_T_M,C11_80_84_T_F,C11_80_84_T_P,C11_85o_Mar_RegM_M,C11_85o_Mar_RegM_F,C11_85o_Mar_DFM_M,C11_85o_Mar_DFM_F,C11_85o_N_mar_M,C11_85o_N_mar_F,C11_85o_T_M,C11_85o_T_F,C11_85o_T_P,C11_T_Marr_reg_marr_M,C11_T_Marr_reg_marr_F,C11_T_Mar_de_fa_mar_M,C11_T_Mar_de_fa_mar_F,C11_Tot_N_mar_M,C11_Tot_N_mar_F,C11_Tot_T_M,C11_Tot_T_F,C11_Tot_T_P
101011001,83,204,246,345,591,141,86,0,3,65,209,206,298,504,70,47,0,0,47,183,117,230,347,3434,3493,780,790,2940,3642,7154,7925,15079
101011002,68,84,209,178,387,75,38,6,4,35,57,116,99,215,27,11,4,0,31,57,62,68,130,2398,2425,373,385,1466,1356,4237,4166,8403
101011003,19,49,81,93,174,47,29,0,0,17,57,64,86,150,21,14,0,0,22,39,43,53,96,1157,1171,230,242,728,873,2115,2286,4401
101011004,13,33,75,75,150,47,22,0,0,16,19,63,41,104,9,6,0,0,7,33,16,39,55,2189,2235,368,409,1078,1016,3635,3660,7295
101011005,43,109,135,179,314,56,38,3,0,30,111,89,149,238,36,18,0,0,25,114,61,132,193,1722,1762,350,354,1260,1588,3332,3704,7036
101011006,40,58,99,122,221,49,24,0,0,36,64,85,88,173,19,8,0,0,17,62,36,70,106,1438,1435,219,224,983,1004,2640,2663,5303
101021007,17,22,49,40,89,18,3,0,0,7,19,25,22,47,6,4,0,0,3,23,9,27,36,621,616,126,134,425,406,1172,1156,2328
101021008,15,41,62,67,129,26,15,0,0,12,40,38,55,93,10,3,0,0,6,41,16,44,60,1460,1476,330,329,1257,1437,3047,3242,6289
101021009,31,92,103,143,246,63,36,0,0,28,88,91,124,215,16,3,0,0,33,108,49,111,160,1415,1433,483,494,1915,1822,3813,3749,7562
101021010,10,25,31,40,71,14,10,0,0,8,24,22,34,56,3,6,0,0,3,31,6,37,43,699,710,233,229,823,790,1755,1729,3484
101021011,27,26,78,60,138,32,22,0,0,12,26,44,48,92,12,0,0,0,9,25,21,25,46,2894,2921,539,525,1471,1437,4904,4883,9787
101021012,14,32,55,56,111,19,9,0,0,6,29,25,38,63,11,3,0,0,5,23,16,26,42,2481,2564,412,404,1381,1557,4274,4525,8799
101031013,12,25,35,38,73,12,13,0,0,13,19,25,32,57,13,8,0,0,13,25,26,33,59,454,448,92,94,354,313,900,855,1755
101031014,26,65,112,106,218,34,22,0,0,21,86,55,108,163,37,16,0,0,26,79,63,95,158,1109,1131,248,248,892,1066,2249,2445,4694
101031015,17,23,49,42,91,16,11,0,0,14,13,30,24,54,6,3,0,0,11,15,17,18,35,655,669,107,110,392,346,1154,1125,2279
101031016,15,23,60,47,107,24,12,0,3,8,18,32,33,65,5,3,0,0,11,18,16,21,37,932,945,256,265,792,659,1980,1869,3849
101041017,37,60,147,130,277,68,50,5,3,36,73,109,126,235,33,16,0,0,22,79,55,95,150,1357,1373,277,276,943,1133,2577,2782,5359
101041018,38,79,165,175,340,96,51,3,0,38,63,137,114,251,41,30,0,0,29,74,70,104,174,1544,1573,252,270,953,1221,2749,3064,5813
101041019,34,57,114,123,237,58,35,0,3,18,84,76,122,198,31,18,0,3,24,68,55,89,144,1386,1406,331,348,1030,1251,2747,3005,5752
101041020,34,41,118,92,210,39,21,0,0,20,32,59,53,112,16,4,0,0,17,34,33,38,71,1638,1669,429,462,1073,1019,3140,3150,6290
101041021,15,32,56,61,117,23,14,0,3,23,28,46,45,91,15,4,0,0,16,27,31,31,62,507,517,89,90,383,416,979,1023,2002
101041022,0,0,0,0,0,0,0,0,0,0,0,0,0,0,0,0,0,0,0,0,0,0,0,14,12,0,0,5,4,19,16,35
101041023,20,25,61,47,108,18,11,0,0,8,35,26,46,72,8,3,0,0,9,18,17,21,38,537,537,129,130,451,538,1117,1205,2322
101041024,14,16,38,35,73,15,11,4,0,8,21,27,32,59,8,7,0,0,8,13,16,20,36,581,590,149,153,450,391,1180,1134,2314
101041025,41,108,199,230,429,104,75,3,0,43,93,150,168,318,65,28,0,0,40,111,105,139,244,1970,1991,367,372,1115,1418,3452,3781,7233
101041026,49,78,169,160,329,77,43,0,0,34,71,111,114,225,36,15,0,0,22,64,58,79,137,1498,1505,272,284,1011,1141,2781,2930,5711
101041027,46,98,198,225,423,94,58,3,0,45,110,142,168,310,58,35,0,0,45,99,103,134,237,1678,1698,328,342,1131,1230,3137,3270,6407
102011028,17,33,49,58,107,37,27,0,0,16,24,53,51,104,20,10,0,0,11,39,31,49,80,1298,1333,201,221,867,967,2366,2521,4887
102011029,39,80,167,185,352,91,55,4,3,36,84,131,142,273,52,24,4,0,38,84,94,108,202,2171,2194,286,303,1266,1412,3723,3909,7632
102011030,11,12,62,32,94,18,13,0,0,9,17,27,30,57,13,4,0,0,10,26,23,30,53,826,853,141,146,608,513,1575,1512,3087
102011031,49,196,235,377,612,173,120,4,3,46,183,223,306,529,109,55,6,0,62,195,177,250,427,2726,2766,250,260,1573,2394,4549,5420,9969
102011032,64,184,198,294,492,111,83,4,0,50,192,165,275,440,66,45,0,0,62,237,128,282,410,2675,2721,750,763,2812,3632,6237,7116,13353
102011033,9,30,51,54,105,19,12,0,0,9,25,28,37,65,9,3,0,0,4,18,13,21,34,1176,1207,193,191,798,904,2167,2302,4469
102011034,12,103,102,202,304,110,84,3,0,42,144,155,228,383,76,54,0,0,59,165,135,219,354,1317,1346,185,183,860,1427,2362,2956,5318
102011035,8,37,54,63,117,29,17,0,0,12,31,41,48,89,11,8,3,0,15,30,29,38,67,1239,1233,200,219,865,1086,2304,2538,4842
102011036,15,37,59,67,126,23,16,0,0,22,32,45,48,93,14,7,0,0,7,25,21,32,53,1523,1547,237,238,1037,1170,2797,2955,5752
102011037,28,67,110,119,229,27,26,4,0,33,63,64,89,153,21,11,0,0,29,66,50,77,127,1160,1180,192,203,789,938,2141,2321,4462
102011038,26,72,100,136,236,68,50,3,0,23,74,94,124,218,37,20,6,0,23,74,66,94,160,1346,1365,206,220,796,1015,2348,2600,4948
102011039,33,101,162,188,350,70,45,3,0,25,86,98,131,229,33,17,0,0,27,81,60,98,158,2383,2429,385,398,1697,1972,4465,4799,9264
102011040,134,269,382,481,863,203,128,5,3,116,310,324,441,765,126,63,0,3,99,339,225,405,630,3628,3641,862,868,3327,4444,7817,8953,16770
102011041,14,52,113,121,234,58,38,0,0,15,61,73,99,172,41,27,0,0,21,64,62,91,153,1808,1833,290,301,1086,1254,3184,3388,6572
102011042,69,182,248,315,563,126,92,3,3,85,193,214,288,502,79,42,0,3,72,202,151,247,398,2138,2153,451,475,2156,2674,4745,5302,10047
102011043,36,117,128,189,317,74,67,0,0,48,149,122,216,338,70,42,0,0,50,169,120,211,331,1864,1893,321,335,1573,2067,3758,4295,8053
102021044,73,249,269,437,706,191,135,0,3,81,227,272,365,637,126,55,0,0,90,272,216,327,543,3641,3684,713,732,2868,4092,7222,8508,15730
102021045,23,61,113,115,228,32,24,0,0,26,51,58,75,133,20,11,0,0,11,35,31,46,77,1717,1738,412,431,1445,1711,3574,3880,7454
102021046,62,107,186,208,394,85,60,5,3,43,96,133,159,292,44,23,0,0,38,93,82,116,198,1570,1607,333,332,1410,1615,3313,3554,6867
102021047,45,110,176,207,383,84,60,0,0,47,144,131,204,335,58,22,3,4,45,130,106,156,262,2791,2830,513,543,1983,2453,5287,5826,11113
102021048,104,253,340,419,759,157,110,3,3,101,227,261,340,601,90,43,0,0,86,246,176,289,465,3233,3293,730,765,3181,3988,7144,8046,15190
102021049,8,13,23,29,52,9,9,0,0,8,7,17,16,33,8,0,0,0,5,11,13,11,24,633,648,81,82,349,320,1063,1050,2113
102021050,58,102,263,262,525,109,64,3,4,53,110,165,178,343,40,18,4,0,26,76,70,94,164,1913,1938,381,393,1349,1733,3643,4064,7707
102021051,7,20,30,31,61,15,12,0,0,7,11,22,23,45,7,7,0,0,8,11,15,18,33,900,903,153,163,654,727,1707,1793,3500
102021052,28,49,94,87,181,29,23,3,3,19,22,51,48,99,16,3,0,3,18,35,34,41,75,1019,1042,207,206,733,752,1959,2000,3959
102021053,58,171,254,320,574,126,81,3,3,80,163,209,247,456,74,37,0,0,50,172,124,209,333,1969,1994,515,529,2304,2919,4788,5442,10230
102021054,53,117,171,218,389,102,52,0,3,64,135,166,190,356,51,35,3,0,53,148,107,183,290,1433,1452,305,321,1505,1732,3243,3505,6748
102021055,12,26,53,56,109,20,20,0,0,13,25,33,45,78,18,3,0,0,3,16,21,19,40,916,922,149,151,568,772,1633,1845,3478
102021056,19,55,112,131,243,69,30,3,0,11,48,83,78,161,22,12,0,0,17,41,39,53,92,2378,2424,326,348,1204,1533,3908,4305,8213
102021057,39,68,94,104,198,49,30,0,0,17,59,66,89,155,20,10,0,0,24,65,44,75,119,1195,1209,298,301,1374,1612,2867,3122,5989
103011058,65,166,222,321,543,119,70,3,0,62,201,184,271,455,57,25,0,0,40,187,97,212,309,3348,3397,840,855,3183,3818,7371,8070,15441
103011059,25,60,95,121,216,56,28,0,0,6,37,62,65,127,17,9,0,0,7,47,24,56,80,1730,1762,357,371,1034,1167,3121,3300,6421
103011060,15,20,57,56,113,19,13,3,0,17,25,39,38,77,11,5,3,0,9,28,23,33,56,1281,1317,216,227,788,737,2285,2281,4566
103011061,13,32,55,54,109,29,14,0,0,16,28,45,42,87,7,3,0,0,12,27,19,30,49,825,834,164,167,592,530,1581,1531,3112
103021062,42,47,126,104,230,47,40,0,3,30,41,77,84,161,30,15,0,0,24,56,54,71,125,1260,1255,256,268,942,900,2458,2423,4881
103021063,35,88,135,179,314,76,46,0,0,47,106,123,152,275,41,27,0,0,22,98,63,125,188,1547,1563,295,310,1220,1398,3062,3271,6333
103021064,40,31,100,74,174,32,17,0,0,19,35,51,52,103,11,9,0,0,16,45,27,54,81,1053,1068,176,179,759,696,1988,1943,3931
103021065,41,99,157,190,347,64,41,0,0,35,94,99,135,234,27,12,0,0,28,80,55,92,147,1772,1791,297,306,1291,1392,3360,3489,6849
103021066,27,30,71,67,138,38,20,3,0,23,39,64,59,123,20,12,0,0,9,37,29,49,78,739,746,114,109,504,475,1357,1330,2687
103021067,49,98,145,177,322,76,51,0,0,35,94,111,145,256,47,27,0,0,17,101,64,128,192,1755,1802,386,395,1354,1659,3495,3856,7351
103021068,21,19,54,49,103,26,12,0,0,29,27,55,39,94,10,5,0,0,8,19,18,24,42,643,646,79,84,491,432,1213,1162,2375
103021069,20,46,94,104,198,54,26,0,0,20,60,74,86,160,23,14,0,0,18,50,41,64,105,1140,1155,186,196,728,695,2054,2046,4100
103031070,57,108,187,189,376,79,55,0,0,36,104,115,159,274,35,13,3,0,17,128,55,141,196,1968,1984,411,414,1842,2101,4221,4499,8720
103031071,39,57,103,93,196,34,28,3,0,33,47,70,75,145,10,3,0,0,10,33,20,36,56,1453,1474,300,301,1103,1004,2856,2779,5635
103031072,40,76,141,154,295,60,45,0,0,32,89,92,134,226,27,12,0,0,20,89,47,101,148,1703,1745,436,445,1278,1532,3417,3722,7139
103031073,14,30,59,62,121,21,12,0,0,13,29,34,41,75,10,6,0,0,11,27,21,33,54,591,599,131,136,475,496,1197,1231,2428
103031074,42,68,131,145,276,62,28,0,0,24,50,86,78,164,19,7,0,0,35,39,54,46,100,1934,1959,342,351,1335,1089,3611,3399,7010
103031075,0,0,0,0,0,0,0,0,0,0,0,0,0,0,0,0,0,0,0,0,0,0,0,0,0,0,0,0,0,0,0,0
103041076,33,48,105,99,204,51,25,0,3,25,55,76,83,159,15,4,0,0,9,36,24,40,64,1295,1314,199,213,896,938,2390,2465,4855
103041077,73,188,255,339,594,106,70,3,0,50,197,159,267,426,62,33,3,0,62,219,127,252,379,2874,2943,663,679,2835,3542,6372,7164,13536
103041078,29,88,142,175,317,58,33,0,0,21,90,79,123,202,31,20,0,3,17,64,48,87,135,2936,3001,590,621,1869,2303,5395,5925,11320
103041079,44,73,157,146,303,60,39,4,0,26,53,90,92,182,24,13,0,0,17,45,41,58,99,2332,2369,339,343,1225,1210,3896,3922,7818
104011080,89,199,274,354,628,159,104,4,0,64,191,227,295,522,68,29,0,4,56,203,124,236,360,2925,2941,593,631,2506,3312,6024,6884,12908
104011081,56,78,202,165,367,63,30,3,0,32,74,98,104,202,34,12,0,0,34,69,68,81,149,2836,2892,580,598,2127,1872,5543,5362,10905
104011082,93,155,381,371,752,169,99,0,3,84,169,253,271,524,86,39,4,0,45,157,135,196,331,3079,3102,552,578,1991,2383,5622,6063,11685
104021083,18,36,65,70,135,21,17,3,0,11,28,35,45,80,18,10,0,0,10,45,28,55,83,848,874,277,310,740,929,1865,2113,3978
104021084,51,149,219,277,496,119,62,3,3,54,139,176,204,380,63,35,0,0,53,143,116,178,294,2655,2682,600,609,2335,2979,5590,6270,11860
104021085,35,103,153,199,352,77,47,3,0,25,87,105,134,239,32,12,0,0,35,117,67,129,196,1435,1444,333,337,1440,1825,3208,3606,6814
104021086,8,10,43,23,66,10,9,0,0,4,8,14,17,31,8,6,0,0,5,4,13,10,23,688,721,151,153,469,416,1308,1290,2598
104021087,16,20,49,50,99,19,0,3,0,8,30,30,30,60,19,9,0,0,8,21,27,30,57,551,544,133,142,444,499,1128,1185,2313
104021088,13,32,69,74,143,51,27,0,0,9,25,60,52,112,18,9,0,0,8,36,26,45,71,1540,1585,283,286,843,970,2666,2841,5507
104021089,51,145,270,310,580,142,82,4,0,59,142,205,224,429,82,40,4,0,67,170,153,210,363,3411,3493,627,662,2464,3189,6502,7344,13846
104021090,36,46,118,110,228,49,27,0,3,24,58,73,88,161,30,12,0,3,20,36,50,51,101,859,871,185,194,652,758,1696,1823,3519
104021091,49,68,192,191,383,93,59,3,0,39,74,135,133,268,48,23,0,3,38,92,86,118,204,2150,2188,413,434,1495,1660,4058,4282,8340
105011092,21,21,45,37,82,14,8,0,0,9,29,23,37,60,6,0,0,0,3,15,9,15,24,464,459,222,223,590,635,1276,1317,2593
105011093,9,25,37,48,85,18,7,0,0,8,25,26,32,58,0,0,0,0,8,23,8,23,31,693,706,250,250,667,536,1610,1492,3102
105011094,15,22,68,59,127,24,15,0,0,18,34,42,49,91,7,6,0,0,9,30,16,36,52,663,662,181,179,642,622,1486,1463,2949
105011095,27,43,78,82,160,24,17,0,0,18,36,42,53,95,4,0,0,0,15,29,19,29,48,871,882,173,178,723,682,1767,1742,3509
105011096,46,34,82,47,129,23,16,0,0,42,33,65,49,114,9,5,0,3,16,18,25,26,51,822,819,337,333,1310,943,2469,2095,4564
105021097,83,211,284,363,647,146,88,4,0,79,210,229,298,527,58,28,0,0,55,156,113,184,297,2881,2945,692,726,2683,3135,6256,6806,13062
105021098,14,12,24,17,41,3,4,0,0,6,14,9,18,27,4,3,0,0,3,7,7,10,17,371,367,122,130,473,347,966,844,1810
105031099,59,73,147,155,302,67,46,0,0,28,69,95,115,210,33,15,4,0,17,78,54,93,147,1437,1450,267,280,1071,1125,2775,2855,5630
105031100,24,56,73,95,168,33,18,3,0,17,58,53,76,129,13,5,0,0,13,54,26,59,85,1640,1714,391,423,1360,1777,3391,3914,7305
105031101,48,150,185,257,442,99,66,3,0,60,137,162,203,365,64,29,0,0,41,155,105,184,289,2449,2545,571,595,1938,2781,4958,5921,10879
105031102,19,53,67,88,155,35,20,3,0,11,22,49,42,91,12,5,0,0,12,23,24,28,52,1132,1176,323,354,928,1121,2383,2651,5034
105031103,16,15,62,50,112,35,16,0,0,11,17,46,33,79,9,10,0,0,9,8,18,18,36,1099,1151,125,137,573,515,1797,1803,3600
105031104,16,36,63,70,133,37,20,0,0,21,37,58,57,115,14,6,0,0,10,37,24,43,67,818,846,120,132,532,629,1470,1607,3077
105031105,33,64,89,95,184,35,24,0,0,16,42,51,66,117,16,8,0,0,9,36,25,44,69,1130,1149,206,206,867,933,2203,2288,4491
105031106,43,80,132,144,276,62,35,0,0,34,62,96,97,193,16,7,0,0,27,55,43,62,105,1285,1338,301,311,1143,1259,2729,2908,5637
106011107,17,26,67,57,124,25,16,0,0,15,26,40,42,82,9,3,0,0,12,43,21,46,67,1746,1787,390,398,1102,1059,3238,3244,6482
106011108,59,177,240,297,537,96,63,4,4,56,167,156,234,390,44,19,3,0,42,136,89,155,244,3107,3147,746,748,2759,3343,6612,7238,13850
106011109,23,36,68,67,135,31,8,3,0,13,31,47,39,86,13,5,0,0,15,21,28,26,54,1367,1392,229,256,872,944,2468,2592,5060
106011110,34,42,122,96,218,36,21,3,0,28,60,67,81,148,23,12,0,0,23,67,46,79,125,1675,1707,276,287,1100,1073,3051,3067,6118
106011111,48,121,159,206,365,65,49,0,4,47,127,112,180,292,32,11,0,0,31,113,63,124,187,2673,2707,688,705,2355,2675,5716,6087,11803
106011112,30,71,132,143,275,53,41,0,4,19,97,72,142,214,24,10,0,0,21,71,45,81,126,2758,2823,642,664,2195,2064,5595,5551,11146
106011113,10,11,37,34,71,20,20,0,0,7,10,27,30,57,10,0,0,0,5,11,15,11,26,1007,1023,175,181,599,426,1781,1630,3411
106021114,17,32,51,66,117,28,10,0,0,23,42,51,52,103,13,7,0,0,11,46,24,53,77,728,751,194,207,774,753,1696,1711,3407
106021115,66,192,296,380,676,119,65,4,3,47,223,170,291,461,77,40,0,0,53,198,130,238,368,4727,4822,887,921,3318,4176,8932,9919,18851
106021116,13,30,67,68,135,49,27,3,0,11,36,63,63,126,17,10,4,0,7,53,28,63,91,1425,1454,191,196,657,813,2273,2463,4736
106021117,27,99,157,193,350,79,54,3,4,22,111,104,169,273,38,26,5,0,28,97,71,123,194,3233,3313,691,715,2303,2727,6227,6755,12982
106021118,7,25,52,57,109,20,11,0,0,5,25,25,36,61,7,4,0,0,6,18,13,22,35,1785,1843,314,324,1019,1011,3118,3178,6296
106031119,22,40,86,79,165,30,15,0,3,12,30,42,48,90,14,8,0,0,9,21,23,29,52,1001,1036,190,194,692,780,1883,2010,3893
106031120,24,61,97,106,203,36,23,3,0,33,54,72,77,149,14,5,4,0,16,59,34,64,98,1175,1206,260,263,850,957,2285,2426,4711
106031121,82,214,403,474,877,218,154,8,0,61,221,287,375,662,132,55,0,4,73,241,205,300,505,3769,3807,576,583,2284,3043,6629,7433,14062
106031122,34,99,143,200,343,79,40,3,0,27,95,109,135,244,33,19,0,0,36,78,69,97,166,2130,2169,538,545,2088,2374,4756,5088,9844
106031123,6,16,37,37,74,21,10,0,0,4,9,25,19,44,12,3,0,0,8,14,20,17,37,1190,1210,136,137,533,590,1859,1937,3796
106031124,26,43,154,140,294,79,38,3,3,18,34,100,75,175,25,15,3,0,16,43,44,58,102,1026,1032,147,154,501,554,1674,1740,3414
106031125,38,54,130,114,244,47,26,4,0,23,40,74,66,140,17,12,0,0,15,46,32,58,90,2435,2507,462,477,1439,1452,4336,4436,8772
106041126,25,67,83,121,204,36,24,0,0,23,59,59,83,142,16,7,3,0,12,48,31,55,86,1837,1853,508,522,1648,1545,3993,3920,7913
106041127,20,25,42,39,81,11,7,0,0,10,19,21,26,47,8,4,0,0,3,14,11,18,29,693,707,153,158,487,442,1333,1307,2640
106041128,11,52,68,97,165,37,16,3,0,21,47,61,63,124,20,11,3,0,11,57,34,68,102,1022,1044,240,238,728,863,1990,2145,4135
106041129,24,51,102,94,196,38,31,0,0,26,51,64,82,146,22,7,0,0,19,47,41,54,95,1455,1472,324,331,1046,934,2825,2737,5562
107011130,146,300,573,610,1183,256,163,3,0,134,285,393,448,841,109,49,4,0,81,219,194,268,462,4566,4612,756,763,4649,4820,9971,10195,20166
107011131,64,190,325,386,711,154,85,3,3,67,161,224,249,473,59,31,4,0,41,154,104,185,289,4291,4341,640,672,3028,3538,7959,8551,16510
107011132,4,26,55,62,117,14,4,3,3,12,15,29,22,51,7,3,0,0,10,21,17,24,41,1557,1585,187,193,771,912,2515,2690,5205
107011133,0,0,0,0,0,0,0,0,0,0,0,0,0,0,0,0,0,0,0,0,0,0,0,0,0,0,3,0,0,0,3,3
107011134,24,100,146,188,334,70,61,3,0,33,98,106,159,265,43,14,5,0,40,78,88,92,180,3080,3124,375,370,2024,2252,5479,5746,11225
107021135,0,0,0,0,0,0,0,0,0,0,0,0,0,0,0,0,0,0,0,0,0,0,0,3,0,0,0,0,0,3,0,3
107031136,23,50,100,104,204,59,27,0,0,21,74,80,101,181,18,16,0,3,18,40,36,59,95,2665,2728,419,448,1566,1748,4650,4924,9574
107031137,10,48,52,83,135,45,30,0,0,14,33,59,63,122,24,16,0,0,10,44,34,60,94,1235,1252,228,235,957,1154,2420,2641,5061
107031138,25,71,130,156,286,85,50,4,3,30,90,119,143,262,44,29,0,0,45,97,89,126,215,1512,1540,210,220,895,1116,2617,2876,5493
107031139,15,34,75,90,165,47,22,0,0,12,46,59,68,127,20,11,0,0,12,45,32,56,88,1265,1294,135,145,687,756,2087,2195,4282
107031140,24,61,111,117,228,49,30,0,0,9,58,58,88,146,24,15,0,0,23,76,47,91,138,1465,1502,165,172,795,952,2425,2626,5051
107031141,29,80,128,143,271,66,41,0,0,24,67,90,108,198,19,8,0,0,10,42,29,50,79,2845,2887,333,341,1458,1707,4636,4935,9571
107031142,26,72,120,147,267,55,35,4,3,25,73,84,111,195,26,12,0,0,17,65,43,77,120,1887,1914,270,277,1358,1591,3515,3782,7297
107031143,67,208,305,371,676,122,68,0,0,79,189,201,257,458,57,26,0,0,41,137,98,163,261,3383,3420,655,678,3175,3725,7213,7823,15036
107041144,77,192,319,397,716,192,112,0,0,67,207,259,319,578,106,52,0,0,83,235,189,287,476,3708,3755,530,529,3068,3392,7306,7676,14982
107041145,48,136,208,279,487,104,67,3,0,46,169,153,236,389,73,31,0,0,42,147,115,178,293,2509,2546,476,490,2464,3000,5449,6036,11485
107041146,52,156,299,329,628,159,117,0,0,50,136,209,253,462,83,28,0,0,46,166,129,194,323,3944,4006,414,428,2949,3108,7307,7542,14849
107041147,13,38,44,54,98,25,16,0,0,9,30,34,46,80,14,14,0,0,9,33,23,47,70,1647,1667,259,259,998,1037,2904,2963,5867
107041148,24,66,88,123,211,46,34,3,0,18,80,67,114,181,33,18,0,0,19,76,52,94,146,1964,1995,395,436,1331,1489,3690,3920,7610
107041149,106,187,338,346,684,152,88,0,0,72,221,224,309,533,104,56,0,0,72,236,176,292,468,3922,3960,1055,1078,5799,5566,10776,10604,21380
107041150,47,152,197,278,475,123,93,0,0,30,163,153,256,409,67,24,0,3,54,155,121,182,303,3492,3566,533,562,2429,3043,6454,7171,13625
108011151,25,33,79,64,143,28,17,0,4,18,25,46,46,92,20,7,0,0,12,19,32,26,58,877,893,178,185,655,655,1710,1733,3443
108011152,99,154,355,399,754,210,142,7,0,97,182,314,324,638,110,65,0,3,70,196,180,264,444,2634,2679,414,420,1717,2279,4765,5378,10143
108011153,28,27,80,71,151,37,28,0,0,23,24,60,52,112,19,4,0,0,8,20,27,24,51,1037,1065,196,205,759,714,1992,1984,3976
108011154,59,97,201,222,423,107,65,3,3,59,115,169,183,352,45,28,0,0,46,122,91,150,241,1071,1088,181,186,865,1126,2117,2400,4517
108021155,57,120,190,199,389,66,52,0,0,55,104,121,156,277,46,18,0,0,26,117,72,135,207,1995,2037,433,452,1980,2506,4408,4995,9403
108021156,31,51,118,92,210,58,40,0,0,36,64,94,104,198,31,18,0,0,29,49,60,67,127,1604,1607,359,375,1412,1206,3375,3188,6563
108021157,28,48,90,87,177,47,32,0,3,25,54,72,89,161,34,18,0,0,13,67,47,85,132,801,810,131,143,613,792,1545,1745,3290
108021158,51,98,161,182,343,77,67,3,3,37,103,117,173,290,71,33,0,0,55,100,126,133,259,1088,1091,224,236,1059,1314,2371,2641,5012
108021159,34,49,105,114,219,34,26,4,0,19,50,57,76,133,27,8,4,0,18,37,49,45,94,1344,1357,327,349,1038,1026,2709,2732,5441
108021160,35,60,131,115,246,44,34,0,0,36,49,80,83,163,32,16,0,0,32,63,64,79,143,974,982,171,180,645,747,1790,1909,3699
108031161,4,0,7,3,10,5,3,0,0,0,0,5,3,8,0,0,0,0,0,3,0,3,3,60,63,12,14,36,36,108,113,221
108041162,92,181,409,427,836,212,133,6,3,70,179,288,315,603,108,50,0,0,80,192,188,242,430,3290,3341,499,511,1926,2293,5715,6145,11860
108041163,85,248,489,575,1064,292,188,10,3,71,272,373,463,836,156,80,0,0,96,305,252,385,637,5185,5264,893,919,3089,4342,9167,10525,19692
108041164,80,209,354,431,785,189,129,4,3,78,246,271,378,649,97,40,3,0,90,260,190,300,490,2692,2752,474,488,1932,2783,5098,6023,11121
108041165,21,12,68,39,107,22,15,0,0,15,20,37,35,72,8,3,3,0,13,22,24,25,49,1000,1015,210,201,713,612,1923,1828,3751
108041166,34,82,151,189,340,73,38,0,3,38,81,111,122,233,34,22,0,0,35,79,69,101,170,1910,1963,326,337,1186,1509,3422,3809,7231
108051167,22,56,81,115,196,61,26,0,0,14,66,75,92,167,24,11,0,0,20,40,44,51,95,996,1003,157,165,626,662,1779,1830,3609
108051168,41,68,186,174,360,94,54,0,0,34,73,128,127,255,37,13,0,0,26,63,63,76,139,1971,2002,318,319,1067,1297,3356,3618,6974
108051169,97,226,358,419,777,183,119,3,0,70,215,256,334,590,105,42,0,0,78,240,183,282,465,3293,3316,678,699,2733,3638,6704,7653,14357
108051170,53,72,208,146,354,81,42,5,3,51,75,137,120,257,39,13,0,3,29,70,68,86,154,2315,2347,418,408,1548,1484,4281,4239,8520
108051171,27,65,92,121,213,46,31,0,0,23,50,69,81,150,27,7,0,0,13,51,40,58,98,929,948,157,160,686,933,1772,2041,3813
109011172,15,67,107,143,250,65,34,0,0,20,61,85,95,180,30,14,0,0,25,66,55,80,135,2295,2353,454,476,1450,1851,4199,4680,8879
109011173,21,73,102,147,249,53,31,0,0,27,70,80,101,181,26,11,0,0,16,66,42,77,119,1464,1502,329,345,1337,1654,3130,3501,6631
109011174,33,76,114,141,255,74,48,0,0,38,88,112,136,248,35,19,0,0,24,127,59,146,205,1613,1657,369,386,1512,1909,3494,3952,7446
109011175,35,68,108,132,240,63,39,0,0,40,68,103,107,210,35,10,0,0,34,62,69,72,141,2210,2248,279,281,1335,1298,3824,3827,7651
109011176,45,131,166,219,385,81,40,0,0,42,135,123,175,298,33,23,3,0,23,109,59,132,191,2245,2275,464,476,2207,2642,4916,5393,10309
109021177,23,27,62,51,113,16,8,0,0,12,25,28,33,61,6,0,0,0,10,19,16,19,35,515,531,101,102,412,418,1028,1051,2079
109021178,15,34,61,80,141,36,18,0,0,23,24,59,42,101,7,4,0,0,14,38,21,42,63,1081,1115,216,226,739,740,2036,2081,4117
109021179,18,19,55,43,98,18,12,0,0,13,20,31,32,63,4,4,0,0,7,15,11,19,30,677,679,120,125,484,376,1281,1180,2461
109031180,35,53,124,123,247,56,34,0,0,24,59,80,93,173,34,16,0,3,24,69,58,88,146,1072,1079,180,187,734,826,1986,2092,4078
109031181,39,45,129,133,262,76,33,0,0,27,49,103,82,185,26,10,0,0,22,39,48,49,97,1360,1385,218,225,844,692,2422,2302,4724
109031182,26,82,118,148,266,64,40,3,0,39,68,106,108,214,24,5,0,0,33,90,57,95,152,1199,1215,253,254,985,1192,2437,2661,5098
109031183,27,48,102,91,193,41,34,3,0,39,52,83,86,169,24,10,0,0,26,32,50,42,92,1383,1390,228,234,897,706,2508,2330,4838
109031184,22,51,102,113,215,52,24,0,0,16,54,68,78,146,19,12,0,0,16,39,35,51,86,1028,1051,178,185,554,640,1760,1876,3636
109031185,42,81,174,159,333,94,65,3,0,40,84,137,149,286,52,30,0,0,32,78,84,108,192,1808,1817,282,287,1216,1209,3306,3313,6619
110011186,47,179,213,278,491,95,64,0,0,56,173,151,237,388,57,38,0,0,40,157,97,195,292,3244,3305,766,801,2855,3789,6865,7895,14760
110011187,14,28,46,55,101,26,6,0,0,17,38,43,44,87,12,7,0,0,10,26,22,33,55,816,820,158,157,543,520,1517,1497,3014
110011188,18,32,76,87,163,33,25,0,0,14,32,47,57,104,18,4,0,0,10,23,28,27,55,1217,1229,169,177,708,747,2094,2153,4247
110011189,7,33,39,51,90,19,7,0,0,20,29,39,36,75,8,7,0,0,7,27,15,34,49,681,682,91,94,390,379,1162,1155,2317
110021190,43,79,143,154,297,66,36,0,3,30,101,96,140,236,30,18,0,0,20,73,50,91,141,1527,1540,316,317,1146,1307,2989,3164,6153
110021191,54,112,165,195,360,92,40,0,3,31,116,123,159,282,39,17,0,0,30,140,69,157,226,1943,1977,369,380,1464,1856,3776,4213,7989
110021192,21,37,78,79,157,29,7,3,3,12,37,44,47,91,13,3,0,0,10,23,23,26,49,981,996,183,184,690,626,1854,1806,3660
110021193,38,48,115,100,215,35,19,0,3,18,57,53,79,132,18,8,0,0,17,48,35,56,91,1122,1146,207,215,699,711,2028,2072,4100
110021194,30,59,116,102,218,36,26,0,0,16,65,52,91,143,15,8,0,0,19,49,34,57,91,1197,1207,211,225,912,973,2320,2405,4725
110031195,27,55,81,86,167,19,19,0,0,16,50,35,69,104,8,3,0,0,16,51,24,54,78,1146,1157,314,330,1141,1252,2601,2739,5340
110031196,21,15,54,30,84,15,9,0,0,10,14,25,23,48,0,3,0,0,7,15,7,18,25,915,914,282,291,749,553,1946,1758,3704
110031197,30,59,86,101,187,28,28,0,0,19,52,47,80,127,27,7,0,3,14,50,41,60,101,1180,1202,275,277,864,989,2319,2468,4787
110031198,19,29,60,57,117,26,15,0,3,9,27,35,45,80,10,5,0,0,8,21,18,26,44,924,923,145,144,636,532,1705,1599,3304
110041199,40,98,137,171,308,56,39,0,3,28,89,84,131,215,26,10,0,0,27,95,53,105,158,1445,1468,306,313,1169,1420,2920,3201,6121
110041200,18,23,60,49,109,20,15,0,0,12,23,32,38,70,9,3,0,0,4,12,13,15,28,884,893,151,152,593,471,1628,1516,3144
110041201,45,59,135,126,261,47,32,4,3,24,61,75,96,171,27,10,0,0,35,53,62,63,125,1368,1373,263,281,1044,1041,2675,2695,5370
110041202,62,156,296,310,606,135,80,0,0,41,181,176,261,437,62,29,0,0,45,175,107,204,311,3401,3500,670,702,2527,3235,6598,7437,14035
110041203,39,135,168,227,395,93,57,3,4,25,141,121,202,323,50,29,0,0,36,171,86,200,286,2191,2225,462,482,1644,2405,4297,5112,9409
110041204,3,32,27,44,71,10,8,3,0,6,23,19,31,50,0,4,0,0,5,13,5,17,22,643,656,220,231,719,939,1582,1826,3408
110041205,68,112,252,228,480,101,52,0,0,58,114,159,166,325,41,10,0,4,39,105,80,119,199,3503,3605,505,532,2097,2207,6105,6344,12449
111011206,68,169,275,325,600,137,97,5,0,51,160,193,257,450,79,37,0,0,47,179,126,216,342,3352,3414,476,498,2343,2730,6171,6642,12813
111011207,25,69,85,122,207,51,41,3,3,33,71,87,115,202,21,8,0,0,26,53,47,61,108,941,961,201,208,950,1047,2092,2216,4308
111011208,79,226,353,463,816,210,130,0,3,85,222,295,355,650,108,57,3,0,76,185,187,242,429,4392,4475,787,805,3290,3990,8469,9270,17739
111011209,43,140,217,285,502,127,79,5,3,55,173,187,255,442,89,38,0,0,40,182,129,220,349,4309,4400,774,787,3171,3617,8254,8804,17058
111011210,37,75,108,122,230,36,29,0,0,25,71,61,100,161,29,13,0,0,20,74,49,87,136,1293,1320,292,295,1319,1716,2904,3331,6235
111011211,18,43,69,74,143,25,25,3,3,15,34,43,62,105,24,11,0,3,13,25,37,39,76,720,718,85,88,489,520,1294,1326,2620
111011212,49,106,193,218,411,100,67,0,3,49,119,149,189,338,52,28,0,0,43,134,95,162,257,2116,2144,276,289,1546,1724,3938,4157,8095
111011213,23,64,159,164,323,90,56,0,0,23,73,113,129,242,36,15,0,0,30,80,66,95,161,2790,2882,259,262,1298,1558,4347,4702,9049
111011214,31,124,197,249,446,108,91,4,3,35,129,147,223,370,70,27,0,0,50,135,120,162,282,2514,2560,401,411,1681,2226,4596,5197,9793
111021215,39,71,126,129,255,45,34,0,0,30,64,75,98,173,33,16,0,0,15,74,48,90,138,1432,1445,277,284,1259,1520,2968,3249,6217
111021216,23,46,134,117,251,67,51,4,0,28,60,99,111,210,28,17,0,0,22,48,50,65,115,1549,1580,243,254,1036,1220,2828,3054,5882
111021217,20,85,93,132,225,46,40,0,0,26,67,72,107,179,26,7,0,0,25,65,51,72,123,2210,2248,405,432,1319,1561,3934,4241,8175
111021218,66,148,247,309,556,148,102,0,0,55,142,203,244,447,86,52,0,0,63,140,149,192,341,2540,2577,395,420,1825,2135,4760,5132,9892
111021219,55,110,217,241,458,112,75,4,0,54,124,170,199,369,78,40,0,0,44,150,122,190,312,2412,2479,425,446,1934,2231,4771,5156,9927
111021220,36,51,135,123,258,70,34,0,0,28,61,98,95,193,24,18,0,0,29,47,53,65,118,1830,1859,310,326,1119,1206,3259,3391,6650
111021221,16,25,45,40,85,13,7,0,0,14,26,27,33,60,7,3,3,0,10,20,20,23,43,1123,1146,227,243,872,869,2222,2258,4480
111031222,44,109,272,272,544,133,104,0,0,53,137,186,241,427,78,41,0,0,44,125,122,166,288,2924,2996,478,497,2015,2464,5417,5957,11374
111031223,23,71,105,120,225,37,40,0,3,29,48,66,91,157,33,16,4,0,19,47,56,63,119,1428,1454,309,320,1254,1374,2991,3148,6139
111031224,62,108,149,177,326,81,53,0,0,54,114,135,167,302,45,19,0,0,42,134,87,153,240,1637,1671,490,508,2240,2309,4367,4488,8855
111031225,33,182,159,293,452,110,86,3,0,51,193,164,279,443,77,37,0,0,47,214,124,251,375,2842,2883,555,583,2249,3012,5646,6478,12124
111031226,10,39,57,72,129,24,13,0,0,9,24,33,37,70,13,0,0,0,5,22,18,22,40,2255,2302,329,342,1303,1474,3887,4118,8005
111031227,64,117,153,182,335,63,43,0,0,51,135,114,178,292,37,21,0,0,48,138,85,159,244,1911,1935,706,744,2598,2809,5215,5488,10703
111031228,26,95,128,171,299,80,58,3,3,36,129,119,190,309,41,26,0,0,47,128,88,154,242,2306,2379,507,522,2228,2284,5041,5185,10226
111031229,18,63,68,97,165,37,32,0,0,25,59,62,91,153,29,9,0,0,21,68,50,77,127,1258,1276,528,513,2154,2119,3940,3908,7848
111031230,0,0,0,0,0,3,0,0,0,0,0,3,0,3,0,0,0,0,0,0,0,0,0,3,6,0,0,4,0,7,6,13
111031231,20,87,99,150,249,63,49,0,0,24,96,87,145,232,41,25,0,0,40,102,81,127,208,1252,1273,301,305,1976,2024,3529,3602,7131
111031232,15,53,81,101,182,40,33,4,0,27,61,71,94,165,17,7,0,0,17,65,34,72,106,1001,1014,199,212,920,941,2120,2167,4287
111031233,55,175,234,325,559,104,81,3,3,59,209,166,293,459,80,32,3,0,45,196,128,228,356,3431,3460,569,608,2649,3399,6649,7467,14116
111031234,43,102,126,177,303,65,57,3,3,42,126,110,186,296,49,26,0,0,33,141,82,167,249,1594,1604,479,505,2095,2403,4168,4512,8680
111031235,34,65,73,96,169,19,21,0,0,29,59,48,80,128,13,3,0,0,19,54,32,57,89,852,861,481,489,1486,1593,2819,2943,5762
112011236,70,239,305,436,741,197,144,4,3,107,282,308,429,737,140,61,3,6,99,279,242,346,588,2633,2662,594,621,2486,3258,5713,6541,12254
112011237,50,116,221,242,463,130,84,4,3,38,121,172,208,380,79,44,3,0,50,144,132,188,320,3173,3233,500,526,1819,2272,5492,6031,11523
112011238,12,22,43,48,91,19,12,0,0,11,15,30,27,57,16,3,0,0,3,29,19,32,51,858,879,277,263,677,790,1812,1932,3744
112011239,22,58,86,111,197,50,36,4,0,28,57,82,93,175,33,11,3,0,19,54,55,65,120,1082,1123,382,401,1161,1503,2625,3027,5652
112011240,18,38,45,70,115,28,17,0,0,19,65,47,82,129,16,5,0,0,12,64,28,69,97,978,1002,398,414,1574,1696,2950,3112,6062
112011241,33,53,105,107,212,50,23,4,0,28,41,82,64,146,14,6,3,0,24,60,41,66,107,845,856,205,215,779,796,1829,1867,3696
112011242,23,39,75,80,155,35,32,0,0,12,45,47,77,124,23,11,0,0,12,24,35,35,70,1402,1437,262,279,817,1052,2481,2768,5249
112011243,24,46,73,91,164,34,15,0,0,15,43,49,58,107,21,13,0,0,23,46,44,59,103,1022,1047,357,366,1049,1256,2428,2669,5097
112021244,49,132,187,242,429,100,52,3,3,34,134,137,189,326,39,21,0,0,41,151,80,172,252,1950,1975,413,429,1612,2038,3975,4442,8417
112021245,23,31,98,73,171,36,18,3,0,13,36,52,54,106,14,6,0,0,22,27,36,33,69,1275,1296,272,275,952,847,2499,2418,4917
112021246,38,103,157,214,371,85,59,3,3,26,122,114,184,298,43,19,4,0,31,111,78,130,208,2179,2201,452,471,1624,2353,4255,5025,9280
112021247,29,55,107,127,234,55,25,0,3,24,65,79,93,172,25,8,0,0,22,69,47,77,124,1254,1283,313,323,1129,1149,2696,2755,5451
112021248,56,135,167,217,384,101,64,3,0,44,149,148,213,361,52,32,0,0,42,157,94,189,283,1919,1943,645,680,2768,3190,5332,5813,11145
112021249,40,54,144,123,267,66,40,0,0,24,49,90,89,179,26,9,0,0,19,47,45,56,101,2663,2700,619,631,1969,1984,5251,5315,10566
112031250,66,120,199,230,429,92,48,6,3,35,93,133,144,277,46,15,0,0,42,93,88,108,196,1906,1955,362,389,1494,1817,3762,4161,7923
112031251,35,78,119,145,264,66,44,3,0,31,89,100,133,233,43,25,3,0,30,127,76,152,228,1273,1289,257,262,1161,1531,2691,3082,5773
112031252,32,44,119,99,218,44,22,0,0,22,26,66,48,114,17,7,0,0,23,41,40,48,88,1709,1749,405,402,1344,1300,3458,3451,6909
112031253,46,69,171,185,356,89,35,3,0,24,48,116,83,199,29,22,3,0,16,39,48,61,109,2067,2122,528,583,1505,1695,4100,4400,8500
112031254,111,254,382,499,881,233,152,5,4,106,256,344,412,756,127,66,5,0,99,261,231,327,558,3007,3089,671,689,2872,3453,6550,7231,13781
112031255,135,363,617,759,1376,394,267,15,6,129,355,538,628,1166,207,106,7,6,151,360,365,472,837,4965,5054,776,827,3438,4749,9179,10630,19809
113011256,59,142,227,272,499,128,72,0,3,44,137,172,212,384,70,27,0,3,29,136,99,166,265,3173,3206,495,504,2328,2638,5996,6348,12344
113011257,38,54,148,120,268,61,32,3,0,32,61,96,93,189,26,12,0,0,20,48,46,60,106,2488,2500,387,394,1711,1310,4586,4204,8790
113011258,31,83,122,156,278,44,17,0,0,21,83,65,100,165,18,7,0,0,22,62,40,69,109,1632,1659,295,307,1168,1367,3095,3333,6428
113011259,36,54,103,95,198,44,28,0,0,26,62,70,90,160,13,13,0,0,19,56,32,69,101,1054,1069,166,172,849,895,2069,2136,4205
113021260,21,26,53,56,109,9,11,0,0,12,23,21,34,55,14,3,0,0,13,27,27,30,57,634,646,125,131,434,364,1193,1141,2334
113021261,23,41,83,78,161,35,27,3,3,23,55,61,85,146,28,9,3,0,11,61,42,70,112,1023,1038,294,301,845,907,2162,2246,4408
113021262,17,38,76,73,149,36,20,0,0,19,33,55,53,108,14,7,3,0,8,27,25,34,59,921,935,170,176,634,518,1725,1629,3354
113031263,28,46,128,128,256,68,47,0,0,27,98,95,145,240,24,7,0,0,18,81,42,88,130,1455,1490,202,205,882,1097,2539,2792,5331
113031264,15,30,49,56,105,22,12,0,0,10,32,32,44,76,16,10,0,0,11,30,27,40,67,669,681,149,158,476,428,1294,1267,2561
113031265,16,38,54,69,123,21,6,0,0,18,40,39,46,85,12,4,0,0,9,40,21,44,65,919,928,163,165,648,691,1730,1784,3514
113031266,33,68,113,129,242,53,25,0,0,24,84,77,109,186,22,11,0,0,17,80,39,91,130,1237,1257,160,163,829,892,2226,2312,4538
113031267,27,97,166,200,366,79,45,0,3,33,101,112,149,261,42,18,0,0,22,89,64,107,171,3021,3074,455,474,1930,2395,5406,5943,11349
113031268,4,10,31,34,65,22,17,0,0,4,16,26,33,59,13,4,0,0,4,28,17,32,49,538,539,94,98,343,454,975,1091,2066
113031269,49,151,188,271,459,94,55,3,0,42,147,139,202,341,59,37,0,0,45,137,104,174,278,3467,3564,769,817,2645,3289,6881,7670,14551
113031270,28,101,113,169,282,51,34,3,0,42,114,96,148,244,39,18,0,0,39,124,78,142,220,1486,1508,508,537,1975,2403,3969,4448,8417
113031271,49,80,169,156,325,89,54,3,0,43,54,135,108,243,41,15,0,0,29,81,70,96,166,2738,2753,375,397,1606,1567,4719,4717,9436
114011272,55,83,209,196,405,89,67,4,3,44,82,137,152,289,52,21,0,0,32,91,84,112,196,1769,1792,283,300,963,1136,3015,3228,6243
114011273,19,30,71,74,145,37,21,0,0,18,24,55,45,100,17,0,0,0,12,25,29,25,54,673,685,103,115,443,434,1219,1234,2453
114011274,30,44,113,104,217,60,49,3,0,25,50,88,99,187,27,10,0,0,28,67,55,77,132,918,929,146,151,768,714,1832,1794,3626
114011275,0,0,0,0,0,0,0,0,0,0,0,0,0,0,0,0,0,0,0,0,0,0,0,5,6,3,0,0,0,8,6,14
114011276,14,39,70,92,162,48,37,0,0,20,48,68,85,153,30,12,0,3,16,42,46,57,103,747,764,131,136,415,579,1293,1479,2772
114011277,58,128,214,258,472,118,75,3,0,53,127,174,202,376,52,22,0,0,46,107,98,129,227,2796,2844,502,528,2024,2414,5322,5786,11108
114011278,59,131,238,257,495,88,62,0,3,40,139,128,204,332,55,19,4,0,22,110,81,129,210,2652,2713,584,617,2340,2878,5576,6208,11784
114011279,59,129,265,270,535,121,86,0,3,58,118,179,207,386,50,22,3,0,35,101,88,123,211,2268,2328,412,426,1594,1968,4274,4722,8996
114011280,35,66,132,139,271,59,50,3,3,30,59,92,112,204,37,13,0,0,41,68,78,81,159,851,857,106,117,644,650,1601,1624,3225
114011281,13,9,42,27,69,10,7,0,0,10,12,20,19,39,3,3,3,0,3,16,9,19,28,700,708,120,123,396,371,1216,1202,2418
114011282,84,182,325,379,704,183,119,4,3,66,152,253,274,527,101,59,3,0,64,149,168,208,376,2726,2764,419,432,1778,2350,4923,5546,10469
114011283,25,38,91,86,177,43,21,6,0,13,28,62,49,111,20,8,0,0,25,24,45,32,77,963,985,170,167,644,532,1777,1684,3461
114021284,41,159,294,310,604,130,89,0,0,38,153,168,242,410,90,51,0,0,44,191,134,242,376,2566,2629,261,273,1229,1952,4056,4854,8910
114021285,14,20,43,35,78,22,10,0,0,8,18,30,28,58,3,3,0,0,9,14,12,17,29,1043,1067,202,218,703,707,1948,1992,3940
114021286,38,89,142,163,305,61,34,0,0,26,73,87,107,194,34,17,0,0,23,77,57,94,151,1416,1435,239,254,1009,1310,2664,2999,5663
114021287,27,74,122,141,263,82,44,3,0,25,70,110,114,224,31,13,0,0,18,70,49,83,132,1627,1644,308,298,1122,1453,3057,3395,6452
114021288,7,17,45,37,82,23,7,0,0,11,15,34,22,56,3,3,0,0,9,12,12,15,27,727,735,96,100,366,418,1189,1253,2442
114021289,25,50,112,123,235,42,29,4,0,9,39,55,68,123,26,11,4,0,16,28,46,39,85,1255,1282,208,200,678,842,2141,2324,4465
115011290,47,133,221,248,469,97,54,0,0,25,111,122,165,287,52,33,0,0,39,120,91,153,244,4732,4776,450,452,2436,2968,7618,8196,15814
115011291,23,54,145,120,265,54,26,0,3,13,56,67,85,152,19,8,0,0,13,53,32,61,93,4343,4429,222,233,2315,2634,6880,7296,14176
115011292,41,133,239,285,524,156,70,0,0,37,163,193,233,426,59,22,3,0,35,122,97,144,241,6208,6331,468,492,3439,3968,10115,10791,20906
115011293,26,129,205,256,461,130,101,3,0,48,167,181,268,449,90,41,0,0,60,246,150,287,437,5371,5513,175,174,3006,3733,8552,9420,17972
115011294,7,28,76,82,158,57,35,0,0,10,43,67,78,145,22,10,0,0,7,22,29,32,61,1364,1411,68,66,711,812,2143,2289,4432
115011295,18,64,125,124,249,59,18,0,0,9,58,68,76,144,24,12,0,0,11,61,35,73,108,5368,5471,283,298,2523,3020,8174,8789,16963
115011296,8,36,63,74,137,38,27,0,0,12,41,50,68,118,16,5,0,0,20,61,36,66,102,3005,3072,120,129,1632,1839,4757,5040,9797
115021297,45,92,231,202,433,113,56,0,0,47,99,160,155,315,68,31,0,3,28,118,96,152,248,4393,4464,373,391,2640,2782,7406,7637,15043
115021298,7,21,50,55,105,29,23,3,0,18,51,50,74,124,20,9,0,0,25,53,45,62,107,1084,1095,97,107,672,752,1853,1954,3807
115031299,11,6,39,24,63,16,5,0,0,6,7,22,12,34,3,3,0,0,10,10,13,13,26,445,459,97,89,342,258,884,806,1690
115031300,27,73,150,162,312,67,40,4,0,20,58,91,98,189,36,12,0,3,22,84,58,99,157,4366,4427,618,636,2679,2626,7663,7689,15352
115041301,18,44,65,82,147,33,15,3,3,14,46,50,64,114,13,8,0,3,7,42,20,53,73,1855,1876,249,261,1190,1181,3294,3318,6612
115041302,17,39,79,79,158,29,16,0,0,7,31,36,47,83,16,3,3,0,12,34,31,37,68,3925,3999,286,280,1862,1929,6073,6208,12281
116011303,31,80,114,136,250,65,37,0,0,31,87,96,124,220,32,18,0,0,13,61,45,79,124,3016,3028,355,354,2420,2269,5791,5651,11442
116011304,53,117,158,201,359,69,37,0,0,31,114,100,151,251,30,13,0,0,25,80,55,93,148,3061,3084,376,379,2680,2911,6117,6374,12491
116011305,75,197,287,321,608,112,62,0,0,52,168,164,230,394,54,22,4,0,41,157,99,179,278,5043,5094,576,593,3967,4368,9586,10055,19641
116011306,27,115,110,168,278,44,27,0,3,30,80,74,110,184,25,9,3,0,19,74,47,83,130,3632,3663,307,324,3011,3560,6950,7547,14497
116011307,62,224,227,342,569,104,61,3,0,81,134,188,195,383,39,28,3,0,40,112,82,140,222,4582,4617,596,632,3562,3871,8740,9120,17860
116011308,58,155,208,250,458,80,44,3,0,42,111,125,155,280,38,24,4,3,30,121,72,148,220,4643,4673,407,414,3216,3551,8266,8638,16904
116021309,14,42,42,65,107,26,13,0,0,10,27,36,40,76,7,3,0,0,3,25,10,28,38,3309,3351,220,239,1778,1943,5307,5533,10840
116021310,19,40,72,66,138,17,8,0,0,13,42,30,50,80,4,3,0,0,7,28,11,31,42,4838,4892,431,450,1956,2279,7225,7621,14846
116021311,22,76,86,109,195,36,16,0,0,11,62,47,78,125,7,6,0,0,14,49,21,55,76,5340,5405,572,575,3051,3593,8963,9573,18536
116021312,44,57,115,114,229,45,29,0,0,30,57,75,86,161,22,9,0,0,13,67,35,76,111,1944,1962,335,346,1908,1805,4187,4113,8300
116031313,40,92,130,135,265,32,16,4,0,23,37,59,53,112,15,5,0,0,4,41,19,46,65,2385,2400,477,493,3021,3781,5883,6674,12557
116031314,4,19,18,30,48,9,9,0,0,3,14,12,23,35,8,0,0,0,0,12,8,12,20,1503,1513,220,219,1006,1114,2729,2846,5575
116031315,13,70,45,93,138,28,9,0,3,10,68,38,80,118,8,0,0,0,7,49,15,49,64,3683,3715,384,407,2612,2927,6679,7049,13728
116031316,36,83,118,123,241,22,19,0,0,33,46,55,65,120,16,3,0,0,10,39,26,42,68,2056,2054,485,491,2538,3159,5079,5704,10783
116031317,44,115,165,179,344,54,26,0,0,36,104,90,130,220,27,8,0,0,22,69,49,77,126,3512,3537,399,408,3413,3761,7324,7706,15030
116031318,0,0,0,0,0,0,0,0,0,0,0,0,0,0,0,0,0,0,0,0,0,0,0,0,3,0,0,0,0,0,3,3
116031319,16,87,95,139,234,47,34,0,0,22,65,69,99,168,25,8,0,0,21,55,46,63,109,3666,3674,375,387,2780,3155,6821,7216,14037
117011320,0,0,0,0,0,0,0,0,0,0,0,0,0,0,0,0,0,0,0,0,0,0,0,0,0,0,0,4,0,4,0,4
117011321,26,43,75,81,156,28,21,0,0,17,65,45,86,131,15,4,0,0,13,52,28,56,84,1540,1571,286,280,1147,1409,2973,3260,6233
117011322,56,167,235,293,528,126,60,0,0,47,168,173,228,401,46,19,0,0,41,138,87,157,244,3586,3604,553,512,3297,3634,7436,7750,15186
117011323,46,95,136,145,281,62,33,3,0,42,85,107,118,225,31,18,0,0,30,105,61,123,184,1862,1884,254,247,1784,2077,3900,4208,8108
117011324,0,0,0,0,0,0,0,0,0,0,0,0,0,0,0,0,0,0,0,0,0,0,0,0,0,0,0,0,0,0,0,0
117011325,0,0,0,0,0,0,0,0,0,0,0,0,0,0,0,0,0,0,0,0,0,0,0,0,0,0,0,0,0,0,0,0
117021326,77,162,271,296,567,103,65,0,0,51,128,154,193,347,51,16,0,0,42,99,93,115,208,3543,3560,1187,1230,4310,4722,9040,9512,18552
117021327,47,99,125,164,289,64,35,3,0,37,65,104,100,204,33,12,0,0,22,70,55,82,137,2328,2345,1203,1191,3142,3726,6673,7262,13935
117021328,20,25,62,62,124,22,15,0,0,20,33,42,48,90,13,8,0,0,12,30,25,38,63,985,990,425,430,1293,1299,2703,2719,5422
117031329,28,21,43,30,73,11,7,4,0,27,21,42,28,70,0,0,4,0,14,10,18,10,28,680,675,1217,695,2406,1791,4303,3161,7464
117031330,31,50,48,63,111,10,4,0,0,6,31,16,35,51,4,4,0,0,7,28,11,32,43,1503,1518,1634,1306,2672,2703,5809,5527,11336
117031331,53,80,91,120,211,40,18,0,0,36,93,76,111,187,12,7,0,0,16,68,28,75,103,1714,1741,1164,1068,3216,3872,6094,6681,12775
117031332,49,72,93,108,201,25,8,0,0,25,56,50,64,114,14,5,0,0,13,50,27,55,82,1843,1840,1840,1600,4122,4296,7805,7736,15541
117031333,80,86,147,117,264,25,23,0,0,49,84,74,107,181,25,8,0,0,42,98,67,106,173,1217,1223,1803,1138,4031,3687,7051,6048,13099
117031334,29,49,76,77,153,22,8,0,0,20,46,42,54,96,10,0,0,0,5,35,15,35,50,2126,2131,1214,1057,3616,3765,6956,6953,13909
117031335,63,99,122,149,271,54,25,0,3,46,79,100,107,207,19,4,0,0,24,70,43,74,117,1319,1333,1422,887,4383,3501,7124,5721,12845
117031336,50,62,79,88,167,34,15,0,0,21,52,55,67,122,17,11,0,0,16,70,33,81,114,1117,1110,1780,1018,3807,2799,6704,4927,11631
117031337,39,47,85,80,165,32,15,0,0,32,47,64,62,126,21,8,0,0,28,36,49,44,93,2155,2179,1015,859,5111,5212,8281,8250,16531
117031338,92,118,194,194,388,58,28,0,0,62,90,120,118,238,32,8,0,0,33,107,65,115,180,2397,2410,1378,1005,4618,4259,8393,7674,16067
118011339,45,108,135,177,312,78,40,4,0,33,99,115,139,254,44,21,0,4,36,162,80,187,267,2345,2380,1106,1078,2658,3107,6109,6565,12674
118011340,39,78,114,141,255,62,31,0,0,30,83,92,114,206,40,12,0,0,40,118,80,130,210,2280,2313,1289,1224,3332,3514,6901,7051,13952
118011341,51,133,146,198,344,70,66,4,0,41,131,115,197,312,59,21,3,3,47,195,109,219,328,2107,2145,785,736,2291,3046,5183,5927,11110
118011342,0,0,0,0,0,0,0,0,0,0,0,0,0,0,0,0,0,0,0,0,0,0,0,0,0,0,0,0,0,0,0,0
118011343,59,181,248,318,566,155,97,6,3,51,238,212,338,550,140,67,10,0,84,367,234,434,668,3535,3603,1156,1018,2987,4628,7678,9249,16927
118011344,19,71,106,133,239,65,42,3,0,20,94,88,136,224,50,21,0,0,36,106,86,127,213,2017,2031,337,326,1325,1744,3679,4101,7780
118011345,35,64,89,91,180,37,15,3,0,25,61,65,76,141,23,6,0,0,22,53,45,59,104,1740,1747,933,776,2274,2994,4947,5517,10464
118011346,16,83,124,148,272,79,48,7,3,24,83,110,134,244,57,21,3,0,41,130,101,151,252,2221,2269,284,281,1258,1704,3763,4254,8017
118011347,21,65,80,92,172,38,21,3,0,29,72,70,93,163,36,13,0,0,29,128,65,141,206,1094,1103,390,313,912,1541,2396,2957,5353
118021348,61,144,201,225,426,87,55,0,0,60,169,147,224,371,65,35,0,0,57,181,122,216,338,3342,3384,1348,1393,3446,4570,8136,9347,17483
118021349,47,139,217,272,489,146,76,0,0,39,164,185,240,425,78,22,3,0,50,148,131,170,301,3563,3607,811,759,5297,5209,9671,9575,19246
118021350,75,175,253,300,553,141,84,0,3,78,195,219,282,501,74,35,0,0,82,181,156,216,372,3569,3629,448,467,2972,3524,6989,7620,14609
118021351,80,243,337,441,778,182,120,0,0,62,263,244,383,627,121,39,3,3,85,289,209,331,540,4847,4893,884,953,4762,5797,10493,11643,22136
118021352,52,160,189,250,439,106,68,0,0,73,180,179,248,427,65,26,0,4,57,193,122,223,345,3896,3930,1463,1438,4120,5568,9479,10936,20415
119011353,57,157,231,289,520,137,56,3,3,65,172,205,231,436,58,29,0,4,44,190,102,223,325,5410,5439,321,333,4563,5250,10294,11022,21316
119011354,61,144,238,246,484,96,68,0,3,48,153,144,224,368,42,15,0,0,38,134,80,149,229,3760,3785,226,221,3080,3464,7066,7470,14536
119011355,0,0,0,0,0,0,0,0,0,0,0,0,0,0,0,0,0,0,0,0,0,0,0,0,0,0,0,0,0,0,0,0
119011356,16,65,104,124,228,61,36,0,3,28,72,89,111,200,42,16,0,0,29,63,71,79,150,1962,1968,118,117,1482,1645,3562,3730,7292
119011357,60,156,231,268,499,124,62,4,0,53,182,181,244,425,73,40,0,3,47,154,120,197,317,4436,4443,181,189,3711,4141,8328,8773,17101
119011358,59,145,215,262,477,110,80,0,0,66,189,176,269,445,58,31,0,0,73,172,131,203,334,3098,3114,312,311,2281,2800,5691,6225,11916
119011359,74,174,268,346,614,180,101,0,0,80,215,260,316,576,80,35,0,0,81,206,161,241,402,5044,5088,455,469,3409,3891,8908,9448,18356
119011360,43,130,181,252,433,109,73,0,0,27,153,136,226,362,71,27,0,0,55,149,126,176,302,2783,2816,270,289,2221,2629,5274,5734,11008
119011361,51,130,186,243,429,127,85,0,0,54,143,181,228,409,87,44,3,3,55,188,145,235,380,3423,3434,202,204,2936,3300,6561,6938,13499
119021362,73,145,258,256,514,109,50,0,0,53,119,162,169,331,51,22,0,0,35,124,86,146,232,3517,3531,262,269,3029,3299,6808,7099,13907
119021363,56,144,299,305,604,152,74,3,3,50,151,205,228,433,80,29,0,0,47,139,127,168,295,5200,5227,428,403,4546,4735,10174,10365,20539
119021364,64,200,398,423,821,238,131,3,3,52,174,293,308,601,121,47,0,0,54,230,175,277,452,4810,4866,464,482,3112,3682,8386,9030,17416
119021365,51,88,177,173,350,77,49,0,0,42,78,119,127,246,45,19,0,0,27,83,72,102,174,4719,4724,196,179,4107,3276,9022,8179,17201
119021366,41,112,160,194,354,76,43,0,0,40,122,116,165,281,56,18,0,0,32,108,88,126,214,3427,3454,156,164,3190,3185,6773,6803,13576
119021367,30,110,156,208,364,90,52,0,0,44,118,134,170,304,54,28,0,0,27,95,81,123,204,2571,2599,188,197,1864,2142,4623,4938,9561
119031368,47,127,222,243,465,92,39,0,0,34,106,126,145,271,54,27,0,3,35,117,89,147,236,3921,3981,368,343,3322,3937,7611,8261,15872
119031369,54,157,204,286,490,126,93,0,3,42,197,168,293,461,72,33,3,3,53,234,128,270,398,4372,4428,522,535,3329,4016,8223,8979,17202
119031370,36,119,191,210,401,86,64,0,0,36,130,122,194,316,71,29,0,0,46,123,117,152,269,2504,2518,220,222,1842,2329,4566,5069,9635
119031371,25,82,124,167,291,80,53,0,0,32,114,112,167,279,65,35,0,0,30,122,95,157,252,2589,2600,237,240,1569,1911,4395,4751,9146
119031372,54,145,289,336,625,176,108,4,0,66,176,246,284,530,91,35,0,0,61,219,152,254,406,3814,3856,288,285,2248,2714,6350,6855,13205
119031373,55,108,149,177,326,67,34,0,0,22,97,89,131,220,45,18,0,0,31,84,76,102,178,1618,1620,152,152,1612,1969,3382,3741,7123
119031374,28,127,256,295,551,138,87,3,0,45,166,186,253,439,103,43,0,0,57,201,160,244,404,4588,4660,377,367,3437,4086,8402,9113,17515
119041375,25,78,136,158,294,63,34,0,0,35,72,98,106,204,32,8,0,0,34,80,66,88,154,2599,2615,483,429,2438,2457,5520,5501,11021
119041376,59,136,258,278,536,123,59,0,0,51,141,174,200,374,58,30,0,0,59,161,117,191,308,4936,4995,443,446,3684,4113,9063,9554,18617
119041377,33,120,193,231,424,115,54,3,0,37,98,155,152,307,83,46,0,3,39,159,122,208,330,2574,2584,174,175,1686,1977,4434,4736,9170
119041378,27,63,115,125,240,59,33,0,0,23,62,82,95,177,35,18,0,0,13,68,48,86,134,1854,1865,241,217,1462,1629,3557,3711,7268
119041379,43,80,178,165,343,80,43,0,0,30,94,110,137,247,49,23,0,0,40,113,89,136,225,3004,3024,318,330,2242,2582,5564,5936,11500
119041380,44,126,209,235,444,107,59,3,0,41,117,151,176,327,55,21,5,0,46,163,106,184,290,2386,2387,349,361,2080,2553,4815,5301,10116
119041381,39,99,165,192,357,90,47,0,0,24,83,114,130,244,43,18,0,0,26,119,69,137,206,3345,3371,414,393,3233,2989,6992,6753,13745
119041382,63,173,268,307,575,142,82,0,0,69,173,211,255,466,85,50,3,5,69,248,157,303,460,2911,2924,378,383,2070,2850,5359,6157,11516
120011383,39,128,239,261,500,147,75,0,0,41,127,188,202,390,55,21,0,0,43,144,98,165,263,4195,4228,428,431,2410,3008,7033,7667,14700
120011384,19,61,117,138,255,66,26,0,0,25,79,91,105,196,35,22,0,0,18,100,53,122,175,3310,3369,563,553,2720,2908,6593,6830,13423
120011385,55,152,185,270,455,121,61,4,4,44,179,169,244,413,74,33,0,0,46,179,120,212,332,3198,3234,681,718,2187,2975,6066,6927,12993
120011386,48,157,243,309,552,148,81,0,0,51,191,199,272,471,89,24,3,3,37,176,129,203,332,3660,3721,704,716,2552,3500,6916,7937,14853
120021387,30,80,99,122,221,35,16,0,0,29,71,64,87,151,24,7,4,4,9,77,37,88,125,2340,2390,904,892,1851,2682,5095,5964,11059
120021388,51,143,161,209,370,67,36,0,4,40,116,107,156,263,26,11,0,0,39,109,65,120,185,3582,3642,1438,1440,3220,4587,8240,9669,17909
120021389,26,72,79,109,188,29,23,4,0,35,56,68,79,147,18,7,0,0,12,51,30,58,88,2028,2069,789,820,1567,2222,4384,5111,9495
120031390,57,148,226,245,471,111,69,0,3,58,136,169,208,377,60,26,3,0,41,163,104,189,293,3772,3794,697,693,3816,4332,8285,8819,17104
120031391,53,166,243,289,532,128,65,0,3,53,162,181,230,411,84,32,0,0,60,176,144,208,352,3649,3686,438,432,3657,4395,7744,8513,16257
120031392,40,63,143,119,262,55,29,0,0,19,71,74,100,174,30,11,0,0,17,67,47,78,125,1822,1834,293,284,1429,1677,3544,3795,7339
120031393,42,157,180,241,421,113,64,0,0,46,150,159,214,373,41,23,0,0,31,126,72,149,221,3073,3123,342,344,2387,3078,5802,6545,12347
120031394,37,85,142,172,314,67,24,4,0,27,80,98,104,202,34,10,0,0,16,81,50,91,141,2321,2340,786,836,2319,3093,5426,6269,11695
120031395,46,91,168,177,345,87,52,3,0,49,91,139,143,282,59,16,3,0,44,87,106,103,209,2228,2248,532,522,1905,2343,4665,5113,9778
120031396,18,45,81,76,157,35,12,0,0,9,35,44,47,91,8,13,0,0,12,42,20,55,75,2320,2331,284,280,2145,1909,4749,4520,9269
120031397,62,193,250,329,579,145,79,0,3,52,173,197,255,452,76,37,4,3,66,219,146,259,405,4920,4964,312,322,4756,4806,9988,10092,20080
121011398,51,133,204,238,442,124,50,3,0,39,153,166,203,369,63,39,0,0,60,215,123,254,377,4449,4518,637,615,3489,4757,8575,9890,18465
121011399,23,102,137,191,328,75,55,0,0,37,102,112,157,269,56,18,3,0,36,141,95,159,254,3431,3468,593,575,2500,3126,6524,7169,13693
121011400,50,167,222,310,532,122,87,0,0,49,185,171,272,443,99,44,5,0,56,243,160,287,447,4837,4932,647,608,2872,3761,8356,9301,17657
121011401,11,24,54,56,110,29,12,0,0,11,26,40,38,78,12,4,0,0,11,36,23,40,63,1661,1683,462,430,1392,1577,3515,3690,7205
121011402,52,138,284,315,599,172,111,3,0,57,172,232,283,515,107,48,4,0,53,229,164,277,441,5065,5173,519,499,2633,3525,8217,9197,17414
121021403,22,95,130,182,312,92,67,0,0,32,73,124,140,264,57,30,0,0,31,100,88,130,218,3878,3922,387,390,2246,2463,6511,6775,13286
121021404,21,46,85,103,188,40,21,3,0,11,42,54,63,117,19,8,0,0,13,40,32,48,80,2472,2500,300,300,1268,1350,4040,4150,8190
121021405,62,188,245,324,569,133,107,3,3,72,210,208,320,528,111,48,0,0,67,238,178,286,464,5847,5905,681,694,4054,4927,10582,11526,22108
121021406,42,103,208,207,415,86,59,3,0,34,109,123,168,291,55,21,0,0,43,122,98,143,241,3886,3979,290,300,2145,2433,6321,6712,13033
121031407,30,99,211,240,451,131,101,3,0,31,145,165,246,411,103,44,0,0,51,188,154,232,386,4040,4143,216,217,2288,3005,6544,7365,13909
121031408,39,158,234,287,521,128,82,3,3,46,162,177,247,424,92,54,4,0,47,228,143,282,425,4469,4601,300,280,2327,3090,7096,7971,15067
121031409,23,70,172,172,344,106,93,0,0,22,123,128,216,344,84,34,0,0,37,147,121,181,302,3525,3612,204,207,1615,2311,5344,6130,11474
121031410,36,126,311,314,625,198,136,3,3,45,161,246,300,546,131,64,0,0,33,173,164,237,401,4437,4525,219,208,1996,2634,6652,7367,14019
121031411,46,154,290,345,635,195,145,3,0,50,185,248,330,578,139,77,3,0,88,244,230,321,551,4026,4124,225,220,1894,2599,6145,6943,13088
121031412,22,97,236,251,487,127,89,3,0,44,88,174,177,351,89,49,0,0,41,128,130,177,307,3809,3916,198,191,1907,2338,5914,6445,12359
121041413,41,124,153,191,344,52,44,3,0,38,114,93,158,251,46,19,0,0,37,154,83,173,256,2954,2986,918,881,2305,3553,6177,7420,13597
121041414,30,113,115,177,292,59,29,0,0,35,102,94,131,225,29,13,0,0,34,97,63,110,173,2593,2622,1026,1001,2507,3396,6126,7019,13145
121041415,56,201,248,341,589,166,106,0,0,62,219,228,325,553,124,62,0,0,75,325,199,387,586,5016,5176,877,856,2990,4711,8883,10743,19626
121041416,36,126,125,181,306,46,30,0,0,41,127,87,157,244,41,24,0,0,43,170,84,194,278,2348,2390,1083,1038,2575,3491,6006,6919,12925
121041417,12,35,61,65,126,21,24,0,0,15,32,36,56,92,23,3,0,0,11,48,34,51,85,1467,1493,570,526,1425,1642,3462,3661,7123
122011418,37,94,194,199,393,132,87,3,3,29,123,164,213,377,93,47,3,0,65,160,161,207,368,3909,3987,536,536,2004,2538,6449,7061,13510
122011419,41,130,166,232,398,95,76,4,0,35,149,134,225,359,59,20,0,0,52,193,111,213,324,3085,3139,1341,1329,2932,3424,7358,7892,15250
122021420,32,74,141,169,310,78,51,3,3,16,95,97,149,246,54,22,0,0,48,108,102,130,232,2415,2468,378,389,1366,1619,4159,4476,8635
122021421,26,78,144,167,311,90,60,3,3,33,99,126,162,288,55,27,4,3,47,119,106,149,255,2212,2240,227,237,1194,1423,3633,3900,7533
122021422,22,73,115,131,246,57,43,4,0,35,74,96,117,213,31,15,4,0,28,90,63,105,168,2584,2641,446,448,1550,1770,4580,4859,9439
122021423,30,135,204,286,490,129,79,0,0,59,134,188,213,401,78,30,0,3,43,182,121,215,336,4336,4401,622,651,2558,3065,7516,8117,15633
122031424,42,110,185,237,422,102,69,0,0,25,119,127,188,315,65,31,0,0,47,168,112,199,311,2671,2717,263,273,1684,2098,4618,5088,9706
122031425,12,67,83,118,201,56,36,0,0,22,101,78,137,215,37,16,0,0,25,105,62,121,183,1518,1550,160,176,813,1118,2491,2844,5335
122031426,53,145,163,226,389,86,59,0,3,54,148,140,210,350,56,27,3,0,45,157,104,184,288,3851,3895,1115,1138,3559,3873,8525,8906,17431
122031427,41,94,232,239,471,125,72,0,0,41,107,166,179,345,59,16,0,0,35,134,94,150,244,2716,2736,188,196,1317,1686,4221,4618,8839
122031428,42,162,294,358,652,174,111,0,3,60,143,234,257,491,84,32,4,0,62,175,150,207,357,5509,5590,373,386,2587,3028,8469,9004,17473
122031429,47,104,139,173,312,74,56,3,0,31,130,108,186,294,64,32,0,0,52,154,116,186,302,3202,3253,1021,1044,2833,2893,7056,7190,14246
122031430,38,105,165,190,355,90,63,0,0,42,131,132,194,326,50,28,0,0,48,167,98,195,293,3116,3163,429,441,1914,2359,5459,5963,11422
122031431,59,159,241,297,538,138,108,3,3,53,243,194,354,548,121,80,0,0,124,342,245,422,667,4104,4175,867,871,2950,3604,7921,8650,16571
122031432,3,13,33,37,70,16,7,0,0,4,7,20,14,34,5,3,0,0,7,8,12,11,23,786,800,68,70,443,412,1297,1282,2579
123011433,30,96,127,149,276,62,44,0,0,30,111,92,155,247,50,35,0,0,24,112,74,147,221,2438,2463,311,324,1420,1737,4169,4524,8693
123011434,15,65,103,132,235,49,29,0,0,15,57,64,86,150,16,8,4,0,15,57,35,65,100,3309,3358,401,418,1800,2131,5510,5907,11417
123011435,16,48,98,99,197,33,11,0,0,11,50,44,61,105,11,7,0,0,11,45,22,52,74,4666,4712,816,849,2508,3050,7990,8611,16601
123021436,36,87,134,141,275,42,32,0,0,23,93,65,125,190,23,11,0,0,15,51,38,62,100,2935,2971,623,630,2748,3548,6306,7149,13455
123021437,46,121,159,189,348,68,50,3,4,39,104,110,158,268,36,23,0,0,20,93,56,116,172,2673,2699,463,477,2324,2788,5460,5964,11424
123021438,17,71,79,113,192,38,21,0,0,14,45,52,66,118,18,3,0,0,12,42,30,45,75,3421,3460,602,622,2986,3515,7009,7597,14606
123021439,0,0,0,0,0,0,0,0,0,0,0,0,0,0,0,0,0,0,0,0,0,0,0,0,0,0,0,0,0,0,0,0
123021440,27,107,128,175,303,58,38,3,0,26,94,87,132,219,30,13,0,0,32,89,62,102,164,3116,3138,378,382,2585,2820,6079,6340,12419
123021441,28,80,103,134,237,45,28,4,3,24,50,73,81,154,19,12,3,0,17,65,39,77,116,2926,2959,512,539,2382,2654,5820,6152,11972
123021442,52,106,132,156,288,51,22,3,3,29,87,83,112,195,22,14,0,0,21,54,43,68,111,3629,3651,429,450,3215,3756,7273,7857,15130
123021443,22,61,75,85,160,21,18,0,3,19,64,40,85,125,9,3,0,0,7,35,16,38,54,3168,3201,410,428,2621,2984,6199,6613,12812
123021444,27,73,97,123,220,36,24,0,0,14,47,50,71,121,15,8,3,0,12,49,30,57,87,3497,3535,497,506,2966,3366,6960,7407,14367
123031445,8,35,45,64,109,26,16,0,0,7,21,33,37,70,18,6,0,0,4,23,22,29,51,1055,1068,181,192,668,698,1904,1958,3862
123031446,14,20,63,50,113,21,16,0,0,5,26,26,42,68,14,3,0,0,4,22,18,25,43,1515,1542,176,185,872,799,2563,2526,5089
123031447,36,83,143,157,300,55,28,3,0,33,94,91,122,213,32,17,0,0,23,91,55,108,163,2793,2838,545,558,1916,2249,5254,5645,10899
123031448,15,30,60,57,117,28,16,0,0,8,28,36,44,80,14,10,5,0,7,27,26,37,63,1756,1790,237,244,1058,1074,3051,3108,6159
124011449,22,50,79,93,172,24,17,3,0,23,41,50,58,108,12,4,0,0,15,53,27,57,84,811,826,236,241,686,909,1733,1976,3709
124011450,28,118,167,210,377,71,45,3,3,33,97,107,145,252,45,15,0,0,38,107,83,122,205,3928,3999,494,533,2288,2635,6710,7167,13877
124011451,0,0,0,0,0,0,0,0,0,0,3,0,3,3,0,0,0,0,0,0,0,0,0,6,6,0,0,0,3,6,9,15
124011452,47,129,148,194,342,61,31,3,0,38,100,102,131,233,38,19,0,0,35,149,73,168,241,1735,1750,511,528,1851,2481,4097,4759,8856
124011453,30,82,95,121,216,42,20,3,0,22,67,67,87,154,24,13,0,4,16,51,40,68,108,1975,2009,417,481,1359,1750,3751,4240,7991
124011454,44,148,204,264,468,110,76,0,3,39,144,149,223,372,53,31,6,0,44,172,103,203,306,4344,4433,628,701,2619,3257,7591,8391,15982
124011455,23,64,103,123,226,41,19,0,0,16,61,57,80,137,18,7,0,0,18,50,36,57,93,1077,1089,216,219,643,946,1936,2254,4190
124021456,0,0,0,0,0,0,0,0,0,0,0,0,0,0,0,0,0,0,0,0,0,0,0,3,0,0,0,0,3,3,3,6
124031457,26,60,94,97,191,32,26,0,0,21,64,53,90,143,22,14,0,0,15,56,37,70,107,2773,2805,556,587,2198,2419,5527,5811,11338
124031458,21,56,95,88,183,32,12,0,0,18,41,50,53,103,15,7,0,0,15,21,30,28,58,3082,3135,598,612,2267,2594,5947,6341,12288
124031459,22,88,125,142,267,66,30,0,3,26,90,92,123,215,18,19,3,0,18,76,39,95,134,2817,2838,401,409,1677,2011,4895,5258,10153
124031460,21,63,82,104,186,31,14,0,0,7,34,38,48,86,16,3,0,0,11,41,27,44,71,4239,4314,579,617,2225,2736,7043,7667,14710
124031461,37,90,146,157,303,75,41,0,0,21,94,96,135,231,22,11,4,0,25,83,51,94,145,3090,3122,626,636,2298,2821,6014,6579,12593
124031462,32,74,113,129,242,34,22,0,0,26,65,60,87,147,26,13,0,3,14,54,40,70,110,2655,2677,591,616,2603,3054,5849,6347,12196
124031463,10,26,60,63,123,21,11,0,0,12,18,33,29,62,12,7,0,0,13,24,25,31,56,1338,1350,152,148,962,877,2452,2375,4827
124031464,57,125,135,200,335,74,35,0,0,45,128,119,163,282,43,26,3,0,33,164,79,190,269,1555,1575,433,455,2084,2528,4072,4558,8630
124031465,10,26,31,49,80,14,4,0,0,9,15,23,19,42,5,4,0,0,6,21,11,25,36,1001,1016,141,144,643,654,1785,1814,3599
124041466,39,110,143,166,309,58,60,4,0,40,117,102,177,279,43,24,0,0,34,110,77,134,211,2071,2103,465,480,1894,2428,4430,5011,9441
124041467,17,79,85,132,217,40,24,4,3,32,64,76,91,167,22,14,0,0,25,67,47,81,128,2388,2446,586,611,2262,2686,5236,5743,10979
124041468,10,20,34,31,65,13,6,0,0,11,20,24,26,50,4,3,0,0,6,10,10,13,23,1193,1199,169,175,866,777,2228,2151,4379
124051469,3,19,18,22,40,7,0,0,0,3,16,10,16,26,0,4,0,0,6,14,6,18,24,1320,1334,165,172,947,963,2432,2469,4901
124051470,17,61,63,98,161,27,18,0,0,17,45,44,63,107,19,3,0,3,15,42,34,48,82,3868,3909,578,580,2891,3071,7337,7560,14897
124051471,71,195,227,302,529,68,49,4,0,67,149,139,198,337,47,18,0,0,44,143,91,161,252,3793,3825,846,868,4394,4855,9033,9548,18581
125011472,49,116,222,207,429,93,53,0,0,50,125,143,178,321,39,15,0,0,41,129,80,144,224,6052,6105,253,258,5934,5059,12239,11422,23661
125011473,9,12,36,24,60,10,9,0,0,7,19,17,28,45,10,5,0,0,3,21,13,26,39,1930,1962,407,348,1239,1317,3576,3627,7203
125011474,66,144,254,271,525,108,63,0,0,59,186,167,249,416,67,35,0,0,70,198,137,233,370,5772,5787,379,371,5214,5251,11365,11409,22774
125011475,0,0,0,0,0,0,0,0,0,0,0,0,0,0,0,0,0,0,0,0,0,0,0,3,0,0,3,0,0,3,3,6
125021476,46,178,341,369,710,173,104,0,3,58,149,231,256,487,83,38,0,0,41,157,124,195,319,5591,5666,338,325,3182,3812,9111,9803,18914
125021477,65,127,206,224,430,105,60,3,3,43,147,151,210,361,46,24,0,0,45,134,91,158,249,3616,3647,379,409,2836,3101,6831,7157,13988
125021478,51,108,181,209,390,86,47,3,0,41,102,130,149,279,37,19,0,0,34,91,71,110,181,3035,3060,271,277,2438,2781,5744,6118,11862
125031479,48,145,187,249,436,115,74,0,3,60,173,175,250,425,67,39,0,0,46,140,113,179,292,2931,2942,220,224,2776,3058,5927,6224,12151
125031480,49,98,155,167,322,76,39,0,0,41,108,117,147,264,32,6,0,0,43,98,75,104,179,2362,2379,184,180,2543,2589,5089,5148,10237
125031481,42,103,139,166,305,64,43,3,0,28,90,95,133,228,41,10,0,0,20,104,61,114,175,3251,3273,225,229,3116,2994,6592,6496,13088
125031482,56,120,244,227,471,100,39,3,0,33,116,136,155,291,33,17,0,0,19,82,52,99,151,5145,5188,405,415,2985,3456,8535,9059,17594
125031483,43,102,142,167,309,72,39,3,3,33,113,108,155,263,44,25,0,0,43,121,87,146,233,3126,3145,178,175,3002,3090,6306,6410,12716
125031484,53,141,171,230,401,84,52,3,3,40,150,127,205,332,47,20,0,3,38,157,85,180,265,3298,3321,325,326,3003,3429,6626,7076,13702
125031485,56,169,228,284,512,105,78,3,0,74,198,182,276,458,72,32,0,0,61,160,133,192,325,4659,4668,387,399,4143,4621,9189,9688,18877
125031486,0,0,0,0,0,0,0,0,0,0,0,0,0,0,0,0,0,0,0,0,0,0,0,0,0,0,0,0,3,0,3,3
125031487,0,0,0,0,0,0,0,0,0,0,0,0,0,0,0,0,0,0,0,0,0,0,0,3,0,0,0,3,0,6,0,6
125041488,65,185,224,285,509,108,60,0,0,75,180,183,240,423,56,21,0,0,48,193,104,214,318,5185,5191,345,371,3735,3910,9265,9472,18737
125041489,37,90,113,158,271,60,41,0,3,19,78,79,122,201,44,22,0,0,38,133,82,155,237,3263,3266,570,551,3112,3558,6945,7375,14320
125041490,12,39,71,74,145,30,17,0,0,15,36,45,53,98,15,6,0,0,13,32,28,38,66,1778,1811,123,118,931,976,2832,2905,5737
125041491,34,84,113,141,254,52,37,0,0,30,120,82,157,239,38,19,0,0,22,140,60,159,219,3475,3472,405,420,2363,2643,6243,6535,12778
125041492,27,55,98,111,209,48,18,0,0,20,68,68,86,154,12,4,0,0,8,58,20,62,82,4180,4151,403,397,4129,3299,8712,7847,16559
125041493,58,169,299,326,625,134,75,0,0,58,161,192,236,428,57,29,4,0,69,191,130,220,350,4207,4246,385,414,2975,3487,7567,8147,15714
125041494,14,45,117,111,228,50,24,0,0,14,40,64,64,128,21,12,0,0,9,54,30,66,96,2379,2408,193,203,1166,1271,3738,3882,7620
126011495,40,149,258,327,585,169,99,3,0,39,173,211,272,483,86,42,0,3,66,217,152,262,414,5155,5223,331,347,3448,4082,8934,9652,18586
126011496,28,110,236,277,513,154,89,0,3,34,128,188,220,408,64,33,0,0,54,181,118,214,332,4367,4465,272,273,2329,2995,6968,7733,14701
126021497,47,149,245,295,540,140,91,0,0,51,191,191,282,473,95,49,0,3,65,208,160,260,420,4829,4894,335,333,3427,4104,8591,9331,17922
126021498,38,105,153,201,354,101,53,0,0,35,132,136,185,321,38,14,0,0,49,109,87,123,210,2564,2589,419,422,1766,2380,4749,5391,10140
126021499,18,63,94,111,205,54,45,0,0,21,75,75,120,195,50,25,0,3,35,131,85,159,244,1798,1823,203,199,1007,1422,3008,3444,6452
126021500,46,142,157,231,388,81,62,3,0,40,152,124,214,338,67,22,0,0,51,177,118,199,317,2943,2969,485,474,3128,4052,6556,7495,14051
126021501,47,98,191,207,398,114,64,0,0,48,140,162,204,366,58,22,0,0,36,142,94,164,258,2479,2502,195,188,1561,1935,4235,4625,8860
126021502,80,199,333,390,723,188,125,3,0,81,257,272,382,654,98,44,0,0,68,235,166,279,445,5175,5221,569,567,3796,4516,9540,10304,19844
126021503,34,94,140,167,307,65,34,0,0,31,87,96,121,217,28,13,0,0,25,113,53,126,179,3321,3348,476,480,2639,2991,6436,6819,13255
127011504,72,179,171,246,417,58,30,3,3,37,101,98,134,232,24,3,0,0,15,53,39,56,95,2239,2267,285,288,2872,3379,5396,5934,11330
127011505,14,24,83,67,150,39,24,0,0,28,32,67,56,123,18,5,0,0,16,24,34,29,63,1879,1900,195,195,1422,1276,3496,3371,6867
127011506,18,34,86,70,156,32,12,0,0,14,26,46,38,84,12,6,0,0,10,33,22,39,61,1269,1279,97,100,972,873,2338,2252,4590
127011507,23,102,122,148,270,56,21,0,0,16,88,72,109,181,16,0,0,0,19,68,35,68,103,5716,5749,375,378,4156,4680,10247,10807,21054
127011508,7,40,63,59,122,23,9,0,0,13,36,36,45,81,10,3,0,0,9,30,19,33,52,3875,3906,294,292,2194,2479,6363,6677,13040
127021509,18,64,83,109,192,57,17,0,0,20,65,77,82,159,20,5,0,0,12,61,32,66,98,2784,2801,187,193,2539,2982,5510,5976,11486
127021510,24,75,162,149,311,66,38,0,3,29,86,95,127,222,37,11,0,0,19,60,56,71,127,3942,3958,153,158,2998,3045,7093,7161,14254
127021511,65,142,227,258,485,119,51,0,0,56,145,175,196,371,60,24,0,0,50,153,110,177,287,3791,3794,300,310,4175,4753,8266,8857,17123
127021512,56,154,221,268,489,91,38,3,0,38,111,132,149,281,46,27,0,0,27,80,73,107,180,2657,2669,218,231,2687,3078,5562,5978,11540
127021513,46,134,169,235,404,98,54,0,0,42,145,140,199,339,55,20,0,0,35,109,90,129,219,3308,3317,276,280,3380,4008,6964,7605,14569
127021514,12,46,74,79,153,32,10,0,0,15,34,47,44,91,13,7,0,0,10,25,23,32,55,1972,1988,86,80,1607,1629,3665,3697,7362
127021515,46,144,167,222,389,83,50,0,0,40,116,123,166,289,47,15,0,0,29,83,76,98,174,3008,3035,173,161,2961,3387,6142,6583,12725
127021516,51,128,194,222,416,104,50,0,0,29,122,133,172,305,33,10,0,0,26,89,59,99,158,3207,3223,225,229,2869,3326,6301,6778,13079
127021517,8,38,91,74,165,37,11,0,0,13,38,50,49,99,6,4,0,0,8,29,14,33,47,1626,1642,66,69,1227,1432,2919,3143,6062
127021518,5,18,53,58,111,33,10,0,0,5,23,38,33,71,9,0,0,0,12,24,21,24,45,885,889,48,49,670,604,1603,1542,3145
127021519,52,147,252,268,520,95,45,0,0,40,111,135,156,291,41,17,0,3,25,87,66,107,173,3236,3244,274,262,2847,3040,6357,6546,12903
127021520,13,68,93,117,210,42,25,0,0,13,59,55,84,139,24,5,0,0,19,43,43,48,91,2222,2237,104,98,1699,1914,4025,4249,8274
127021521,0,0,0,0,0,0,0,0,0,0,0,0,0,0,0,0,0,0,0,0,0,0,0,3,0,0,0,3,0,6,0,6
127031522,27,87,129,159,288,56,21,0,0,34,87,90,108,198,27,12,0,0,22,84,49,96,145,2826,2860,234,241,1978,2306,5038,5407,10445
127031523,30,67,140,141,281,63,31,0,0,19,57,82,88,170,24,15,3,3,17,58,44,76,120,3237,3261,361,371,2171,2339,5769,5971,11740
127031524,18,42,83,89,172,42,22,0,0,21,63,63,85,148,14,6,0,0,9,42,23,48,71,3832,3915,518,557,2127,2304,6477,6776,13253
127031525,65,197,230,304,534,103,48,0,0,47,161,150,209,359,42,16,0,0,39,120,81,136,217,4784,4790,389,390,4579,4918,9752,10098,19850
127031526,60,172,185,240,425,67,41,0,3,31,128,98,172,270,33,12,3,4,30,85,66,101,167,4844,4892,406,418,3486,3988,8736,9298,18034
128011527,83,227,312,448,760,227,168,7,0,76,306,310,474,784,129,62,4,0,81,278,214,340,554,5026,5138,700,717,3362,4241,9088,10096,19184
128011528,83,188,324,391,715,178,128,7,3,67,265,252,396,648,118,67,0,0,92,282,210,349,559,5049,5153,1297,1311,4595,5005,10941,11469,22410
128011529,38,112,218,237,455,127,77,0,0,48,130,175,207,382,43,19,0,0,41,115,84,134,218,3555,3636,437,430,2062,2579,6054,6645,12699
128011530,51,168,275,367,642,173,117,3,0,53,199,229,316,545,103,55,0,0,58,202,161,257,418,3347,3393,469,494,2419,3078,6235,6965,13200
128011531,44,136,267,298,565,195,118,0,0,45,193,240,311,551,98,51,0,3,51,221,149,275,424,3282,3316,318,315,1830,2464,5430,6095,11525
128021532,42,127,239,265,504,116,70,6,5,45,119,167,194,361,54,22,0,0,41,109,95,131,226,6181,6268,585,605,3259,3538,10025,10411,20436
128021533,20,55,87,101,188,38,32,0,0,22,47,60,79,139,27,14,0,0,10,78,37,92,129,1351,1362,148,149,778,979,2277,2490,4767
128021534,11,28,65,67,132,32,18,0,0,8,33,40,51,91,16,9,0,0,11,26,27,35,62,2478,2506,118,121,1537,1561,4133,4188,8321
128021535,28,62,112,128,240,77,32,0,0,14,84,91,116,207,20,9,0,0,19,65,39,74,113,4510,4590,363,383,2723,3090,7596,8063,15659
128021536,43,100,187,223,410,124,82,0,0,43,129,167,211,378,62,20,3,0,55,117,120,137,257,4526,4580,458,467,2358,2762,7342,7809,15151
128021537,0,0,0,0,0,0,0,0,0,0,0,0,0,0,0,0,0,0,0,0,0,0,0,0,3,0,0,3,0,3,3,6
128021538,43,149,200,275,475,121,85,3,3,53,198,177,286,463,65,36,3,0,52,202,120,238,358,3383,3404,745,755,2760,3498,6888,7657,14545
197979799,0,0,0,0,0,0,0,0,0,0,0,0,0,0,0,0,0,0,0,0,0,0,0,0,0,0,0,0,0,0,0,0
