region_id,Intct_fam_no_otr_chld_pre_Fam,Step_fam_no_otr_chld_pre_Fam,Blnd_fam_no_otr_chld_pre_Fam,Intct_fam_othr_child_pres_Fam,Step_fam_othr_child_pres_Fam,Blnd_fam_othr_child_pres_Fam,Otr_cpl_fam_otr_chld_only_Fam,Tot_Families
1100101,0,0,0,0,0,0,0,0
1100102,77,8,3,0,0,0,0,88
1100103,0,0,0,0,0,0,0,0
1100104,3,0,0,0,0,0,0,3
1100105,17,4,3,0,0,0,0,24
1100106,12,0,4,0,0,0,0,16
1100107,26,0,3,0,0,0,0,29
1100108,19,3,0,0,0,0,0,22
1100109,37,3,0,0,0,0,0,40
1100110,43,10,3,0,0,0,3,59
1100111,64,8,3,0,0,0,0,75
1100112,59,6,3,0,0,0,0,68
1100113,43,7,4,0,0,0,0,54
1100114,32,3,0,0,0,0,3,38
1100115,30,3,3,0,0,0,0,36
1100116,28,4,3,0,0,0,0,35
1100117,24,5,3,0,0,0,0,32
1100118,31,4,4,0,0,0,0,39
1100119,19,3,0,0,0,0,0,22
1100120,39,6,4,0,0,0,0,49
1100121,8,4,0,0,0,0,0,12
1100122,40,5,10,0,0,0,0,55
1100123,30,0,3,3,0,0,0,36
1100124,26,6,5,0,0,0,0,37
1100125,48,0,3,0,0,0,0,51
1100126,38,0,4,0,0,0,0,42
1100127,32,4,3,0,0,0,0,39
1100128,18,4,0,0,0,0,0,22
1100129,43,0,0,0,0,0,0,43
1100130,18,0,4,0,0,0,0,22
1100131,23,3,0,0,0,0,0,26
1100132,51,3,10,0,0,0,0,64
1100133,31,7,3,0,0,0,0,41
1100134,39,5,0,0,0,0,4,48
1100135,50,5,5,0,0,0,0,60
1100136,54,6,3,0,0,0,0,63
1100137,17,3,4,0,0,0,0,24
1100138,20,7,0,0,0,0,4,31
1100139,14,4,0,0,0,0,4,22
1100140,13,0,4,0,0,0,0,17
1100141,41,3,6,3,0,0,0,53
1100142,18,3,6,0,0,0,0,27
1100143,35,3,0,0,0,0,0,38
1100144,28,3,0,0,0,0,0,31
1100145,12,4,4,0,0,0,0,20
1100146,29,9,0,0,0,0,0,38
1100147,30,4,6,0,0,0,3,43
1100148,25,3,0,0,0,0,0,28
1100149,48,0,0,0,0,0,0,48
1100150,29,4,0,0,0,0,0,33
1100151,20,4,0,4,0,0,0,28
1100152,17,3,0,0,0,0,0,20
1100153,33,7,9,4,0,0,0,53
1100154,64,4,9,0,0,0,0,77
1100155,9,0,4,0,0,0,0,13
1100156,31,5,0,0,0,0,0,36
1100157,32,7,0,4,0,0,0,43
1100158,28,3,0,0,0,0,0,31
1100159,10,0,0,0,0,0,0,10
1100160,0,0,0,0,0,0,0,0
1100161,41,6,0,0,0,0,0,47
1100201,55,3,4,0,0,3,0,65
1100202,21,3,0,0,0,3,0,27
1100203,13,0,3,0,0,0,0,16
1100204,29,0,0,0,0,0,0,29
1100205,48,6,3,0,0,0,0,57
1100206,39,3,3,6,0,0,0,51
1100207,63,6,0,0,0,0,0,69
1100208,42,0,0,0,0,0,0,42
1100209,20,3,0,0,0,0,0,23
1100210,26,0,3,0,0,0,0,29
1100211,16,0,3,0,0,0,0,19
1100212,42,5,4,0,0,0,0,51
1100213,23,3,0,3,0,0,0,29
1100214,25,4,0,0,0,0,0,29
1100215,22,3,0,0,0,0,0,25
1100216,58,3,3,0,0,0,0,64
1100217,34,3,3,0,0,0,0,40
1100218,23,4,3,0,0,0,0,30
1100219,36,4,3,0,0,0,0,43
1100220,22,7,3,0,0,0,0,32
1100221,30,0,0,0,0,0,0,30
1100222,47,8,5,0,0,0,0,60
1100223,37,3,0,3,0,0,3,46
1100224,26,0,0,0,0,0,0,26
1100225,33,5,0,0,0,0,0,38
1100226,55,0,7,0,0,0,0,62
1100227,49,0,0,0,0,0,0,49
1100228,38,7,0,0,0,0,0,45
1100229,26,3,0,0,0,0,0,29
1100230,17,3,4,3,0,0,0,27
1100231,31,0,0,0,0,0,4,35
1100232,18,4,3,0,0,0,0,25
1100233,19,0,3,0,0,0,0,22
1100301,56,6,6,0,0,0,0,68
1100302,14,0,0,0,0,0,0,14
1100303,19,0,0,0,0,0,0,19
1100304,58,3,3,0,0,0,0,64
1100305,59,4,0,0,0,0,0,63
1100306,43,3,5,0,0,0,0,51
1100307,39,0,3,3,0,0,0,45
1100308,33,0,0,0,0,0,0,33
1100309,57,4,4,0,0,0,0,65
1100310,45,4,3,0,0,0,0,52
1100311,61,4,4,0,0,0,0,69
1100312,61,3,5,0,0,0,0,69
1100313,49,6,0,0,0,3,0,58
1100314,55,6,7,0,0,0,0,68
1100401,17,0,0,0,0,0,0,17
1100402,30,5,0,0,0,0,0,35
1100403,13,0,0,0,0,0,0,13
1100404,132,3,10,0,0,0,0,145
1100405,35,3,0,0,0,0,0,38
1100406,31,4,4,0,0,0,0,39
1100407,58,4,4,0,0,0,0,66
1100408,49,5,3,0,0,0,0,57
1100409,21,3,3,0,0,0,0,27
1100410,44,3,0,3,0,0,0,50
1100411,40,3,3,0,0,0,0,46
1100412,34,3,3,3,0,0,0,43
1100413,24,3,3,0,0,0,0,30
1100414,24,4,0,0,0,0,0,28
1100415,55,0,7,0,0,0,0,62
1100416,53,7,4,4,0,0,0,68
1100417,33,0,4,0,0,0,0,37
1100418,0,0,0,0,0,0,0,0
1100419,12,0,0,0,0,0,0,12
1100420,45,5,0,0,0,0,0,50
1100421,21,3,0,0,0,0,0,24
1100422,33,3,0,0,0,0,0,36
1100423,13,3,3,0,0,0,0,19
1100424,40,3,0,0,0,0,3,46
1100425,58,4,5,0,0,0,0,67
1100426,42,4,3,3,0,0,0,52
1100427,28,0,0,0,0,0,0,28
1100428,49,3,0,0,0,0,0,52
1100429,28,4,0,0,0,0,0,32
1100430,27,3,3,0,0,0,0,33
1100431,66,0,4,0,0,0,0,70
1100432,41,0,3,0,0,0,0,44
1100433,29,5,0,0,0,0,0,34
1100434,28,5,3,0,0,0,0,36
1100501,23,0,0,0,0,0,0,23
1100502,31,3,3,4,0,0,0,41
1100503,62,3,0,3,0,0,0,68
1100504,54,3,3,3,0,0,0,63
1100505,47,5,4,0,0,0,0,56
1100506,24,3,6,0,0,0,3,36
1100507,19,0,3,0,0,0,0,22
1100508,13,0,5,0,0,0,0,18
1100509,41,5,4,0,0,0,0,50
1100510,30,4,3,0,0,0,0,37
1100511,15,0,3,0,0,0,0,18
1100512,34,3,3,0,0,0,0,40
1100513,44,5,4,0,0,0,0,53
1100514,49,10,3,0,0,3,0,65
1100515,52,3,0,0,0,0,3,58
1100516,34,0,3,0,0,0,0,37
1100517,64,4,0,0,0,0,0,68
1100518,29,4,0,0,0,0,0,33
1100519,25,0,4,3,0,0,0,32
1100520,47,4,0,0,0,0,0,51
1100521,11,0,3,0,0,0,0,14
1100522,29,5,0,0,0,0,0,34
1100523,9,0,0,0,0,0,0,9
1100524,21,4,0,0,0,0,0,25
1100525,22,5,3,0,0,0,0,30
1100526,30,0,3,0,0,0,0,33
1100527,41,8,3,0,0,0,0,52
1100528,0,0,0,0,0,0,0,0
1100529,14,3,3,3,0,0,0,23
1100530,15,6,0,0,0,0,0,21
1100601,44,0,3,3,0,0,0,50
1100602,28,0,0,0,0,0,0,28
1100603,12,0,4,0,0,0,0,16
1100604,31,4,0,0,0,0,4,39
1100605,30,4,3,0,0,0,0,37
1100606,23,4,0,0,0,0,0,27
1100607,26,3,0,0,0,0,0,29
1100608,27,3,0,0,0,0,0,30
1100609,38,0,0,0,0,0,0,38
1100610,18,0,0,0,0,0,0,18
1100611,21,0,4,0,0,0,0,25
1100612,49,0,3,0,0,0,0,52
1100613,60,5,0,0,0,0,0,65
1100614,33,0,5,0,0,0,0,38
1100615,17,0,0,0,0,0,0,17
1100616,28,4,4,0,0,0,0,36
1100617,47,0,0,0,0,0,3,50
1100618,25,0,3,3,0,0,0,31
1100619,48,3,3,0,0,0,0,54
1100620,30,3,4,0,0,0,0,37
1100621,34,4,0,3,0,0,3,44
1100701,19,4,0,0,0,0,3,26
1100702,32,0,3,0,0,0,0,35
1100703,33,3,3,0,0,0,3,42
1100704,32,0,0,0,0,0,0,32
1100705,32,3,3,0,0,0,0,38
1100706,14,3,3,0,0,0,0,20
1100707,12,4,0,0,0,0,0,16
1100708,42,3,3,0,0,0,3,51
1100709,38,0,0,0,0,0,0,38
1100710,22,3,3,0,0,0,0,28
1100801,38,0,3,0,0,0,0,41
1100802,69,6,7,0,0,0,0,82
1100803,25,3,3,0,0,0,0,31
1100804,30,6,0,0,0,0,0,36
1100805,10,3,3,0,0,0,0,16
1100806,36,4,3,4,0,0,0,47
1100807,40,10,3,0,0,0,0,53
1100808,60,3,3,3,0,3,3,75
1100809,0,0,0,0,0,0,0,0
1100810,45,0,3,0,0,0,0,48
1100811,37,4,0,0,0,0,0,41
1100812,38,0,3,0,0,0,0,41
1100813,73,3,3,0,0,0,0,79
1100814,56,10,3,0,0,0,0,69
1100815,37,3,3,0,0,0,3,46
1100816,25,6,4,0,0,0,0,35
1100817,27,8,6,0,0,0,0,41
1100818,31,0,4,0,0,0,3,38
1100819,66,3,3,0,0,3,0,75
1100820,38,3,3,3,0,0,0,47
1100821,65,4,3,0,0,3,0,75
1100822,42,0,0,0,0,0,0,42
1100823,33,7,0,0,0,0,0,40
1100901,17,5,3,0,0,0,0,25
1100902,39,0,0,0,3,0,0,42
1100903,82,6,9,0,0,0,0,97
1100904,34,7,3,0,0,0,0,44
1100905,43,3,4,0,0,0,0,50
1100906,35,4,5,0,0,0,0,44
1100907,33,4,0,0,0,0,0,37
1100908,23,5,3,0,0,0,0,31
1100909,25,4,0,0,0,0,0,29
1100910,25,4,0,0,0,0,0,29
1100911,31,0,3,0,0,3,0,37
1100912,27,3,0,3,0,0,3,36
1100913,72,9,7,0,0,0,0,88
1100914,38,0,4,0,0,0,0,42
1100915,59,3,0,0,0,0,0,62
1100916,46,7,6,0,0,0,0,59
1100917,14,3,0,0,0,0,0,17
1100918,45,3,0,0,0,0,0,48
1100919,43,0,0,0,0,0,0,43
1100920,15,0,0,4,0,0,0,19
1100921,16,3,0,0,0,0,0,19
1100922,40,7,0,0,0,0,0,47
1101001,10,0,0,0,0,0,0,10
1101002,59,0,0,0,0,0,0,59
1101003,50,3,0,0,0,0,0,53
1101004,37,3,0,0,0,0,0,40
1101005,59,7,4,0,0,0,0,70
1101006,24,3,3,0,0,0,0,30
1101007,17,3,3,0,0,0,0,23
1101008,30,0,0,0,0,0,0,30
1101009,31,3,0,3,0,0,0,37
1101010,29,0,0,3,0,0,0,32
1101011,0,0,0,0,0,0,0,0
1101012,11,0,0,0,0,0,0,11
1101013,0,0,0,0,0,0,0,0
1101014,14,0,4,0,0,0,0,18
1101015,27,3,3,0,0,0,0,33
1101101,46,4,3,0,0,0,0,53
1101102,32,0,0,4,0,0,0,36
1101103,32,0,0,0,0,0,0,32
1101104,33,6,4,0,0,0,0,43
1101105,62,4,3,0,0,0,0,69
1101106,37,3,4,3,0,0,0,47
1101107,40,3,7,0,0,0,0,50
1101108,38,5,6,0,0,0,0,49
1101109,37,6,0,0,0,0,0,43
1101110,46,3,0,3,0,0,0,52
1101111,45,3,3,0,0,0,0,51
1101112,13,6,3,0,0,0,0,22
1101113,11,3,0,0,0,0,0,14
1101114,40,4,4,0,0,0,0,48
1101115,43,6,0,0,0,0,0,49
1101116,22,7,3,0,0,0,0,32
1101117,29,4,4,0,0,0,0,37
1101118,35,5,0,0,0,0,0,40
1101119,37,0,0,4,0,0,0,41
1101120,82,3,3,3,0,0,3,94
1101121,44,3,0,0,0,0,0,47
1101122,30,3,0,0,0,0,0,33
1101123,33,3,0,4,0,0,0,40
1101124,129,16,7,0,0,0,0,152
1101125,58,13,3,0,0,0,0,74
1101126,46,4,4,0,0,0,0,54
1101127,50,0,0,0,0,0,0,50
1101128,34,6,0,0,0,0,0,40
1101129,56,3,0,0,0,0,0,59
1101130,74,7,4,0,0,0,0,85
1101131,31,4,0,0,0,0,0,35
1101132,46,0,3,0,0,0,0,49
1101133,35,0,0,0,0,0,0,35
1101134,37,3,0,0,0,0,0,40
1101135,38,0,3,0,0,0,3,44
1101136,39,5,0,0,0,0,0,44
1101137,39,0,3,0,0,0,0,42
1101138,86,7,3,0,0,0,0,96
1101139,32,0,3,0,0,0,0,35
1101140,52,3,0,0,0,0,0,55
1101201,25,0,3,0,0,0,0,28
1101202,44,0,0,0,0,0,0,44
1101203,93,11,3,0,0,0,0,107
1101204,58,6,0,0,0,0,0,64
1101205,62,4,0,0,0,0,0,66
1101206,59,10,3,0,0,0,0,72
1101207,34,0,3,0,0,0,0,37
1101208,51,5,3,0,0,0,0,59
1101209,125,3,3,0,0,0,3,134
1101210,54,12,0,0,0,0,0,66
1101211,98,8,12,0,0,0,0,118
1101212,58,5,4,0,0,0,0,67
1101213,84,3,3,0,0,0,0,90
1101214,96,3,3,3,0,0,0,105
1101215,65,5,0,0,0,0,0,70
1101216,61,4,0,0,0,0,0,65
1101217,3,0,0,0,0,0,0,3
1101218,63,4,0,0,0,0,0,67
1101219,45,6,0,0,0,0,0,51
1101220,46,3,3,0,0,0,0,52
1101221,42,8,3,0,0,0,0,53
1101222,77,4,4,0,0,0,0,85
1101223,60,11,3,0,0,0,0,74
1101224,83,3,0,0,0,0,0,86
1101225,0,0,0,0,0,0,0,0
1101226,0,0,0,0,0,0,0,0
1101227,74,6,4,0,0,0,0,84
1101228,53,9,4,0,0,0,0,66
1101229,40,7,0,0,0,0,0,47
1101230,18,0,0,0,0,0,0,18
1101231,35,6,7,0,0,0,0,48
1101232,75,4,4,0,0,0,0,83
1101301,17,5,0,0,0,0,0,22
1101302,39,4,0,0,0,0,0,43
1101303,23,0,3,0,0,0,0,26
1101304,42,4,0,0,0,0,0,46
1101305,13,0,3,0,0,0,3,19
1101306,16,0,0,0,0,0,0,16
1101307,33,0,0,0,0,0,0,33
1101308,23,4,0,0,0,0,0,27
1101401,27,3,3,0,0,0,0,33
1101402,31,0,5,0,0,0,0,36
1101403,25,0,3,0,3,0,0,31
1101404,29,3,0,0,0,0,3,35
1101405,28,3,0,0,0,0,0,31
1101406,41,4,3,0,0,0,0,48
1101407,40,4,3,0,0,0,0,47
1101408,26,0,0,0,0,0,0,26
1101409,22,8,0,0,0,0,0,30
1101410,34,3,0,0,0,0,3,40
1101411,29,0,4,0,0,0,3,36
1101412,47,8,3,0,0,0,3,61
1101413,26,0,3,0,0,0,0,29
1101414,21,0,0,0,0,0,0,21
1101415,30,7,3,0,0,0,0,40
1101416,45,0,0,3,0,0,0,48
1101417,0,0,0,0,0,0,0,0
1101418,43,3,3,0,0,0,0,49
1101501,0,0,0,0,0,0,0,0
1101502,3,0,0,0,0,0,0,3
1101503,20,0,3,0,0,0,0,23
1101504,19,3,0,0,0,0,0,22
1101505,11,0,0,0,0,0,0,11
1101506,35,3,3,0,0,0,0,41
1101507,23,0,0,0,0,0,0,23
1101508,37,3,0,0,0,0,0,40
1101509,62,5,0,0,0,0,0,67
1101510,41,3,3,0,0,0,0,47
1101511,16,0,0,0,0,0,0,16
1101512,18,3,0,0,0,0,0,21
1101513,25,0,4,0,0,0,0,29
1101601,10,0,0,0,0,0,0,10
1101602,36,4,8,0,0,0,0,48
1101603,31,0,5,3,0,0,0,39
1101604,14,3,0,0,0,0,0,17
1101605,13,3,0,0,0,0,0,16
1101606,43,3,3,0,0,0,0,49
1101607,20,3,0,0,0,0,0,23
1101608,33,0,5,0,0,0,0,38
1101609,11,0,0,0,0,0,0,11
1101610,88,8,3,0,0,3,0,102
1101611,17,0,0,0,0,0,0,17
1101612,3,0,0,0,0,0,0,3
1101613,41,0,0,0,0,0,0,41
1101614,18,4,0,0,0,0,0,22
1101615,46,0,3,0,0,0,0,49
1101616,27,0,0,0,0,0,0,27
1101617,22,3,0,0,0,0,0,25
1101618,56,0,4,0,0,0,0,60
1101619,59,0,0,0,0,0,0,59
1101620,11,0,0,0,0,0,0,11
1101701,22,8,3,0,0,0,0,33
1101702,18,4,0,0,0,0,0,22
1101703,32,5,0,0,0,0,0,37
1101704,13,3,0,0,0,0,0,16
1101705,4,3,0,0,0,0,0,7
1101706,11,3,3,0,0,0,0,17
1101707,0,0,0,0,0,0,0,0
1101708,31,0,4,0,0,0,0,35
1101709,71,7,5,0,0,0,0,83
1101710,32,3,0,0,0,0,0,35
1101711,34,0,0,0,0,0,0,34
1101712,46,3,3,3,0,0,0,55
1101713,24,3,3,0,0,0,3,33
1101714,0,0,0,0,0,0,0,0
1101715,0,0,0,0,0,0,0,0
1101716,28,4,9,0,0,0,0,41
1101717,16,0,0,0,0,0,0,16
1101718,14,6,0,0,0,0,0,20
1101719,29,3,3,0,0,0,0,35
1101720,22,0,3,3,0,0,0,28
1101721,36,3,3,0,0,0,0,42
1101722,35,3,0,0,0,0,3,41
1101801,25,3,3,0,0,0,0,31
1101802,21,4,0,0,0,0,0,25
1101803,49,4,0,0,0,0,0,53
1101804,7,0,0,0,0,0,0,7
1101805,20,3,0,0,0,0,0,23
1101806,22,3,0,3,0,0,0,28
1101807,30,9,4,0,0,0,0,43
1101808,35,6,3,0,0,0,0,44
1101809,4,0,0,0,0,0,3,7
1101810,17,3,3,0,0,0,0,23
1101811,26,3,0,0,0,3,0,32
1101812,21,7,3,0,0,0,0,31
1101813,10,4,3,0,0,0,0,17
1101814,22,0,0,0,0,0,0,22
1101815,17,4,0,0,0,0,0,21
1101816,21,4,0,0,0,0,0,25
1101817,43,5,3,0,0,0,0,51
1101818,36,3,3,0,0,0,0,42
1101819,23,6,3,0,0,0,0,32
1101820,17,5,0,0,0,0,0,22
1101821,19,0,3,0,0,0,0,22
1101822,21,0,5,0,0,0,0,26
1101823,11,4,3,4,0,0,0,22
1101824,0,0,0,0,0,0,0,0
1101901,29,7,3,0,0,0,0,39
1101902,23,4,5,0,0,0,0,32
1101903,9,0,3,0,0,0,0,12
1101904,41,3,5,0,0,0,0,49
1101905,24,6,3,0,0,0,0,33
1101906,42,3,3,0,0,0,0,48
1101907,37,3,0,0,0,0,0,40
1101908,37,8,0,0,0,0,0,45
1101909,20,0,3,0,0,0,0,23
1101910,15,3,0,0,0,0,0,18
1101911,33,3,3,0,0,0,3,42
1101912,37,3,0,0,0,0,0,40
1101913,34,3,3,0,0,0,3,43
1101914,70,3,5,0,0,0,0,78
1101915,27,0,3,0,0,0,0,30
1101916,47,4,3,0,0,0,3,57
1101917,68,6,3,0,0,0,0,77
1101918,27,5,0,0,0,0,0,32
1101919,15,3,3,0,0,0,0,21
1101920,19,4,3,0,0,0,0,26
1101921,17,0,0,0,0,0,0,17
1101922,19,0,3,0,0,0,0,22
1102001,43,4,0,0,0,0,0,47
1102002,53,7,3,0,0,0,0,63
1102003,38,3,3,0,0,0,0,44
1102004,21,4,4,0,0,0,0,29
1102005,12,0,0,0,0,0,0,12
1102006,33,6,0,0,0,0,0,39
1102007,31,3,3,0,0,0,4,41
1102008,40,7,0,0,0,0,0,47
1102009,0,0,0,0,0,0,0,0
1102010,0,0,0,0,0,0,0,0
1102011,32,0,3,3,0,0,0,38
1102012,0,0,0,0,0,0,0,0
1102013,12,0,0,0,0,0,0,12
1102014,16,3,0,0,0,0,0,19
1102015,11,3,0,3,0,0,0,17
1102016,31,0,0,3,0,0,0,34
1102017,26,4,0,0,0,0,4,34
1102018,36,3,0,0,0,3,0,42
1102019,32,3,0,3,0,0,0,38
1102020,43,3,5,0,0,0,3,54
1102021,0,0,0,0,0,0,0,0
1102022,28,4,4,0,0,0,0,36
1102023,31,7,0,0,0,0,0,38
1102024,17,0,0,0,0,0,0,17
1102025,34,6,3,0,0,0,0,43
1102026,20,0,0,0,0,0,0,20
1102027,19,3,4,3,0,0,0,29
1102028,43,4,4,0,0,0,0,51
1102029,22,0,0,0,0,0,0,22
1102030,33,0,3,0,0,0,0,36
1102031,16,3,3,0,0,0,0,22
1102032,19,3,3,0,0,0,0,25
1102101,25,3,0,0,0,0,0,28
1102102,15,4,0,0,0,0,0,19
1102103,49,0,5,0,0,0,0,54
1102104,30,0,4,0,0,0,0,34
1102105,13,4,3,0,0,0,3,23
1102106,31,0,3,0,0,0,0,34
1102107,40,8,3,3,0,0,0,54
1102201,4,0,0,0,0,0,0,4
1102301,24,3,0,0,0,0,0,27
1102302,28,3,4,0,0,0,0,35
1102303,30,3,3,0,0,0,0,36
1102304,11,3,0,0,0,0,0,14
1102305,36,3,3,0,0,0,0,42
1102306,20,0,0,0,0,0,0,20
1102307,19,0,0,0,0,0,0,19
1102308,38,5,0,0,0,0,4,47
1102309,22,0,0,0,0,0,0,22
1102310,0,0,0,0,0,0,0,0
1102401,24,0,0,0,0,0,0,24
1102402,26,6,0,3,0,3,0,38
1102403,24,0,0,0,0,3,0,27
1102404,36,6,0,0,0,0,0,42
1102405,19,0,0,4,0,0,0,23
1102406,23,0,0,0,0,0,0,23
1102407,20,0,0,0,0,0,0,20
1102408,24,3,0,0,0,0,0,27
1102409,19,5,0,0,0,0,0,24
1102410,21,3,0,3,0,0,0,27
1102411,19,3,0,0,0,0,0,22
1102412,31,0,0,0,0,0,0,31
1102501,0,0,0,0,0,0,0,0
1102502,18,3,0,0,0,0,0,21
1102503,6,0,0,0,0,0,0,6
1102504,8,0,0,0,0,0,0,8
1102505,9,3,0,0,0,0,0,12
1102506,25,0,3,0,0,0,0,28
1102507,16,0,0,4,0,0,0,20
1102508,29,4,0,0,0,0,0,33
1102509,10,3,3,0,0,0,0,16
1102510,29,3,3,0,0,0,0,35
1102511,34,3,3,0,0,0,0,40
1102512,32,3,4,0,0,0,0,39
1102513,51,5,0,0,0,0,0,56
1102514,15,6,0,0,0,0,0,21
1102515,26,4,3,0,0,0,0,33
1102516,26,0,0,0,0,0,0,26
1102517,24,4,5,0,0,0,3,36
1102518,37,3,0,0,0,0,0,40
1102519,22,0,0,0,0,0,0,22
1102520,35,5,3,0,0,0,0,43
1102521,10,5,0,0,0,0,0,15
1102522,30,3,0,0,0,0,0,33
1102523,15,0,0,0,0,0,0,15
1102524,40,0,4,0,0,0,0,44
1102525,27,3,3,0,0,0,0,33
1102526,34,3,0,0,0,0,0,37
1102527,34,3,3,0,0,0,0,40
1102528,37,9,0,0,0,3,0,49
1102529,14,3,0,0,0,0,0,17
1102530,25,3,0,0,0,0,0,28
1102601,25,4,0,0,0,0,3,32
1102602,21,8,3,0,0,0,0,32
1102603,19,0,3,0,0,0,0,22
1102604,17,3,3,0,0,0,0,23
1102605,23,4,0,0,0,0,0,27
1102606,21,3,0,0,0,0,0,24
1102607,42,3,0,0,0,0,0,45
1102608,23,3,4,0,0,0,0,30
1102609,29,6,0,0,0,0,0,35
1102610,22,3,3,0,0,0,0,28
1102611,33,0,0,0,0,0,0,33
1102612,16,0,0,0,0,0,0,16
1102613,16,0,4,0,0,0,0,20
1102614,38,7,3,0,0,3,3,54
1102615,36,4,0,0,0,0,0,40
1102616,15,3,0,0,0,0,0,18
1102617,22,0,3,0,0,0,0,25
1102618,23,0,3,0,0,0,0,26
1102619,40,3,0,0,0,0,0,43
1102620,19,0,3,0,0,0,0,22
1102621,16,4,6,0,0,0,0,26
1102622,32,0,0,0,0,0,0,32
1102623,16,3,3,0,0,0,0,22
1102701,12,0,0,0,0,0,0,12
1102702,24,3,3,0,0,0,0,30
1102703,6,0,0,0,0,0,0,6
1102704,13,3,3,0,0,0,0,19
1102705,27,0,3,0,0,0,3,33
1102706,27,0,0,0,0,0,0,27
1102707,31,3,4,0,0,0,0,38
1102708,15,0,3,0,0,0,0,18
1102709,40,12,0,0,0,0,0,52
1102710,12,0,0,0,0,0,3,15
1102711,0,0,0,0,0,0,0,0
1102712,29,7,3,0,0,0,0,39
1102713,36,4,0,0,0,0,0,40
1102714,0,0,0,0,0,0,0,0
1102715,3,0,0,0,0,0,0,3
1102716,0,0,0,0,0,0,0,0
1102717,12,3,0,3,0,0,0,18
1102718,15,3,0,0,0,0,0,18
1102719,28,6,0,0,0,0,0,34
1102720,21,4,3,0,0,0,0,28
1102721,29,3,0,0,0,0,0,32
1102722,6,3,0,3,0,0,3,15
1102723,19,3,0,0,0,0,0,22
1102724,21,10,0,0,0,0,0,31
1102725,15,4,3,0,0,0,0,22
1102726,12,0,0,0,0,0,0,12
1102727,20,6,0,0,0,0,0,26
1102728,15,0,0,0,0,0,0,15
1102729,38,0,0,0,0,0,0,38
1102801,0,0,0,0,0,0,0,0
1102802,80,10,0,0,0,0,0,90
1102803,51,5,0,0,0,0,0,56
1102804,37,0,0,0,0,0,0,37
1102805,40,4,0,0,0,0,0,44
1102806,50,3,3,3,0,0,0,59
1102807,36,5,4,0,0,0,0,45
1102808,71,0,0,0,0,0,0,71
1102809,80,4,3,0,0,0,0,87
1102810,63,3,4,0,0,0,0,70
1102811,60,3,3,0,0,0,0,66
1102812,38,9,0,0,0,0,3,50
1102813,36,3,3,0,0,0,0,42
1102814,47,0,5,0,0,0,0,52
1102815,48,3,3,0,0,0,0,54
1102816,34,4,3,0,0,0,0,41
1102817,41,5,0,0,0,0,0,46
1102818,52,3,3,0,0,0,0,58
1102901,33,5,0,0,0,0,0,38
1102902,23,4,0,0,0,0,0,27
1102903,50,3,0,0,0,0,0,53
1102904,64,9,3,0,0,0,0,76
1102905,38,3,5,0,0,3,0,49
1102906,14,4,0,0,0,0,0,18
1102907,26,0,3,0,0,0,0,29
1102908,42,3,0,0,0,0,0,45
1102909,31,3,0,0,0,0,0,34
1102910,67,0,4,0,0,0,0,71
1102911,41,3,3,0,0,0,0,47
1102912,48,8,0,0,0,0,0,56
1102913,36,0,0,0,0,0,0,36
1102914,40,4,0,0,0,0,0,44
1102915,73,6,4,0,0,0,0,83
1102916,47,5,0,0,0,0,0,52
1102917,27,3,0,0,0,0,0,30
1102918,46,3,0,0,0,0,0,49
1102919,15,3,3,0,0,0,0,21
1102920,3,0,0,0,0,0,0,3
1102921,0,0,0,0,0,0,0,0
1102922,76,3,3,3,0,0,0,85
1102923,57,3,3,0,0,0,0,63
1102924,91,7,0,0,0,0,0,98
1102925,53,0,3,3,0,0,0,59
1102926,23,3,3,0,0,0,0,29
1102927,46,5,3,0,0,0,0,54
1102928,32,3,0,0,0,0,0,35
1103001,50,8,5,0,0,0,0,63
1103002,64,6,4,0,0,0,0,74
1103003,28,3,0,0,0,0,0,31
1103004,39,3,4,0,0,0,0,46
1103005,34,3,0,0,0,0,0,37
1103006,41,4,0,0,0,0,0,45
1103007,37,3,3,3,0,0,0,46
1103008,23,3,0,0,0,0,0,26
1103009,38,5,5,0,0,0,0,48
1103010,33,3,0,0,0,0,0,36
1103011,35,0,0,0,0,0,0,35
1103012,45,6,0,0,0,0,0,51
1103101,40,10,3,0,0,0,0,53
1103102,15,0,0,0,0,0,0,15
1103103,0,0,0,0,0,0,0,0
1103104,22,4,0,0,0,0,0,26
1103105,60,3,3,0,0,0,0,66
1103106,25,4,0,0,0,0,0,29
1103107,5,4,0,0,0,0,0,9
1103108,32,8,3,0,0,0,0,43
1103109,36,3,0,0,0,0,3,42
1103110,51,4,6,0,0,0,0,61
1103111,33,5,0,0,0,0,0,38
1103112,23,3,3,0,0,0,0,29
1103113,71,5,4,0,0,0,0,80
1103114,65,4,4,0,0,0,0,73
1103115,78,3,0,0,0,0,3,84
1103116,50,4,3,0,0,0,0,57
1103117,30,9,3,0,0,0,0,42
1103118,45,3,0,0,0,0,0,48
1103119,59,0,6,0,0,0,0,65
1103120,53,3,0,0,0,0,0,56
1103121,25,3,3,0,0,0,0,31
1103122,48,0,4,0,0,0,4,56
1103123,37,3,0,0,3,0,0,43
1103124,34,0,4,0,0,0,0,38
1103125,17,3,3,3,0,0,0,26
1103126,6,0,0,0,0,0,0,6
1103127,34,0,3,4,0,0,0,41
1103128,22,0,0,0,0,0,0,22
1103129,71,13,5,0,0,0,0,89
1103130,43,3,0,0,3,0,0,49
1103131,3,0,0,0,0,0,0,3
1103132,3,0,0,0,0,0,0,3
1103133,49,7,3,0,0,0,0,59
1103134,43,3,3,0,0,0,0,49
1103135,50,7,3,0,0,0,0,60
1103136,44,5,3,0,0,0,0,52
1103137,0,0,0,0,0,0,0,0
1103138,53,10,0,0,0,0,0,63
1103201,40,6,0,0,0,0,0,46
1103202,34,4,3,0,0,0,0,41
1103203,113,4,5,0,0,0,0,122
1103204,31,5,0,0,0,0,0,36
1103205,15,0,0,0,0,0,0,15
1103206,0,0,0,3,0,0,0,3
1103207,6,4,0,0,0,0,0,10
1103208,24,0,3,0,0,0,0,27
1103209,126,4,4,0,0,0,0,134
1103210,8,0,0,0,0,0,0,8
1103211,58,3,3,0,0,0,0,64
1103212,55,8,0,0,0,0,0,63
1103213,0,0,0,0,0,0,0,0
1103214,83,6,5,0,0,0,0,94
1103215,20,0,3,0,0,0,0,23
1103216,36,3,3,0,0,0,0,42
1103217,18,0,3,3,0,0,0,24
1103218,70,8,3,0,0,0,3,84
1103219,19,5,0,0,0,0,0,24
1103220,13,0,0,0,0,0,0,13
1103221,15,0,0,0,0,0,0,15
1103222,25,6,0,0,0,0,0,31
1103223,0,0,0,0,0,0,0,0
1103224,15,0,0,0,0,0,0,15
1103225,29,0,3,0,0,0,0,32
1103226,12,0,0,0,0,0,0,12
1103227,29,3,3,0,0,0,0,35
1103228,39,3,0,0,0,0,0,42
1103229,18,3,0,3,0,0,0,24
1103230,24,3,3,0,0,0,0,30
1103231,28,6,0,0,0,0,0,34
1103232,39,0,6,3,0,0,0,48
1103233,38,4,0,0,0,0,0,42
1103234,82,6,9,0,0,0,0,97
1103235,21,0,0,0,0,0,0,21
1103236,16,3,0,0,0,0,0,19
1103237,11,0,3,0,0,0,3,17
1103238,35,3,0,3,0,0,0,41
1103239,47,8,0,0,0,0,0,55
1103240,12,0,0,0,0,0,0,12
1103241,21,0,0,0,0,0,0,21
1103242,24,3,3,0,0,0,0,30
1103243,55,3,3,0,0,0,0,61
1103244,37,0,3,0,0,0,0,40
1103301,32,3,0,0,0,0,0,35
1103302,63,3,4,0,0,0,0,70
1103303,41,8,5,3,0,0,0,57
1103304,63,0,5,0,0,0,0,68
1103305,50,4,3,0,0,0,0,57
1103306,37,4,3,0,0,0,0,44
1103307,27,3,0,0,0,0,3,33
1103308,60,3,3,0,0,0,0,66
1103309,4,0,0,0,0,0,0,4
1103310,44,4,7,0,0,0,0,55
1103311,43,0,5,4,0,0,0,52
1103312,45,3,4,0,0,0,0,52
1103313,51,0,0,0,0,0,0,51
1103314,40,4,5,0,0,0,0,49
1103315,116,5,8,0,0,0,0,129
1103316,0,0,0,0,0,0,0,0
1103317,65,8,3,0,0,0,0,76
1103318,27,0,0,5,0,0,0,32
1103319,50,3,8,3,0,0,0,64
1103320,0,0,0,0,0,0,0,0
1103401,49,4,5,0,0,0,0,58
1103402,31,6,4,0,0,0,0,41
1103403,56,10,4,0,0,0,0,70
1103404,29,3,3,0,0,0,0,35
1103405,40,4,7,3,0,0,0,54
1103406,15,3,0,0,0,0,0,18
1103407,38,0,0,0,0,0,0,38
1103408,46,3,3,0,0,0,0,52
1103409,36,4,0,0,0,0,0,40
1103410,43,3,3,0,0,0,0,49
1103411,61,3,0,3,0,0,0,67
1103412,55,10,8,0,0,3,0,76
1103413,54,4,3,0,0,0,0,61
1103414,24,3,0,0,0,0,0,27
1103415,4,3,0,0,0,0,0,7
1103416,37,4,0,0,0,0,0,41
1103417,28,4,0,3,0,0,3,38
1103418,0,0,0,0,0,0,0,0
1103419,42,4,5,0,0,0,0,51
1103501,74,9,3,0,0,0,0,86
1103502,27,7,5,0,0,0,0,39
1103503,61,3,4,3,3,0,0,74
1103504,49,8,4,0,0,0,0,61
1103505,58,3,3,0,0,0,0,64
1103506,76,4,4,0,0,0,0,84
1103507,31,3,0,0,0,0,0,34
1103508,57,6,3,3,0,0,3,72
1103509,39,0,0,0,0,0,0,39
1103510,48,4,7,0,0,0,0,59
1103511,60,5,0,4,0,0,0,69
1103512,34,4,0,4,0,0,4,46
1103513,41,0,4,0,0,0,0,45
1103514,51,3,0,0,0,0,0,54
1103515,32,0,3,0,0,0,0,35
1103516,29,0,6,0,0,0,0,35
1103517,5,0,0,0,0,0,0,5
1103601,44,0,3,0,0,0,0,47
1103602,39,0,3,0,0,0,0,42
1103603,74,0,4,4,0,0,0,82
1103604,35,3,3,3,0,0,3,47
1103605,59,6,0,0,0,0,0,65
1103606,38,0,0,0,0,0,0,38
1103607,23,3,0,0,0,0,0,26
1103608,35,10,3,0,0,0,0,48
1103609,50,6,4,0,0,0,0,60
1103610,69,4,8,0,0,0,0,81
1103611,31,4,0,0,0,0,0,35
1103612,19,3,0,0,0,0,0,22
1103613,51,4,3,0,0,0,0,58
1103614,79,3,3,0,0,0,0,85
1103615,30,4,0,4,0,0,0,38
1103616,43,3,4,0,0,0,3,53
1103617,43,3,4,0,0,0,0,50
1103618,40,5,3,0,0,0,0,48
1103619,54,7,3,0,0,0,0,64
1103620,47,4,3,0,0,0,0,54
1103621,92,6,0,3,0,0,0,101
1103622,38,3,5,0,0,0,0,46
1103701,65,13,7,0,0,0,0,85
1103702,54,8,4,0,0,0,0,66
1103703,67,7,3,0,0,0,0,77
1103704,37,0,0,0,0,0,0,37
1103705,60,3,4,0,0,0,0,67
1103706,47,4,3,0,0,0,0,54
1103707,70,4,0,0,0,0,0,74
1103708,22,0,0,0,0,0,0,22
1103709,55,5,0,0,0,0,3,63
1103710,43,3,0,0,0,0,0,46
1103711,33,0,3,0,0,0,0,36
1103712,24,0,0,0,0,0,0,24
1103713,41,0,0,0,0,0,0,41
1103714,52,6,0,0,0,0,0,58
1103801,49,3,3,0,0,0,0,55
1103802,50,9,3,0,0,0,0,62
1103803,30,3,7,0,0,0,0,40
1103804,47,3,6,0,0,0,0,56
1103805,28,6,0,3,0,0,0,37
1103806,15,8,3,0,3,0,0,29
1103807,42,5,4,0,0,0,0,51
1103808,3,0,0,0,0,0,0,3
1103809,63,0,0,0,0,0,4,67
1103810,35,6,0,0,0,0,0,41
1103811,49,8,3,0,0,0,0,60
1103812,44,0,0,0,0,0,0,44
1103813,63,4,4,4,0,0,0,75
1103814,42,7,3,3,0,0,0,55
1103815,39,0,4,0,0,0,0,43
1103816,48,6,4,0,0,0,0,58
1103817,41,4,0,5,0,0,0,50
1103901,79,5,0,0,0,0,0,84
1103902,44,3,6,0,0,0,0,53
1103903,19,0,0,0,0,0,0,19
1103904,55,4,4,0,0,0,0,63
1103905,58,4,0,0,0,0,0,62
1103906,42,4,4,0,0,0,3,53
1103907,63,3,3,0,0,0,0,69
1103908,49,3,3,0,0,0,0,55
1103909,46,3,3,0,0,0,0,52
1103910,45,14,0,0,0,0,0,59
1103911,52,3,0,0,0,0,0,55
1103912,56,6,3,0,0,0,0,65
1103913,78,5,5,0,0,0,0,88
1103914,34,4,4,3,0,0,0,45
1103915,45,0,3,0,0,0,0,48
1103916,45,6,0,0,0,0,0,51
1103917,37,3,3,0,0,0,0,43
1103918,72,6,0,0,0,0,0,78
1103919,32,0,3,0,0,0,0,35
1103920,31,7,0,0,0,0,0,38
1103921,38,5,3,0,0,0,0,46
1103922,83,3,3,0,0,0,0,89
1103923,36,5,0,0,0,0,0,41
1103924,0,0,0,0,0,0,3,3
1103925,55,7,3,0,0,0,0,65
1103926,49,0,0,0,0,0,0,49
1103927,54,4,4,0,0,0,0,62
1104001,34,3,7,0,0,0,0,44
1104002,8,0,0,0,0,0,0,8
1104003,37,0,5,0,3,0,0,45
1104004,42,4,4,0,0,0,0,50
1104005,35,0,0,0,0,0,0,35
1104006,30,6,0,0,0,0,0,36
1104007,20,0,3,0,0,0,0,23
1104008,0,0,0,0,0,0,0,0
1104009,13,3,3,0,0,0,3,22
1104010,9,3,0,0,0,0,0,12
1104011,17,4,0,0,0,0,0,21
1104012,31,3,3,0,0,0,0,37
1104013,48,6,3,0,0,0,0,57
1104014,16,4,0,0,0,0,0,20
1104015,9,3,0,0,0,0,0,12
1104016,20,3,0,0,0,0,0,23
1104017,32,4,6,0,0,0,0,42
1104018,44,0,7,0,0,0,0,51
1104019,30,3,6,0,0,0,0,39
1104020,34,4,4,0,0,0,0,42
1104021,33,4,3,0,0,0,0,40
1104022,17,0,0,0,0,0,0,17
1104023,23,4,3,0,0,0,0,30
1104024,27,4,0,0,0,0,0,31
1104025,27,4,0,0,0,0,0,31
1104026,21,0,3,0,0,0,0,24
1104027,13,3,0,0,0,0,0,16
1104028,51,4,3,0,0,0,0,58
1104029,19,0,3,0,0,0,0,22
1104030,18,0,0,0,0,0,0,18
1104031,24,0,3,0,0,0,0,27
1104032,12,0,5,0,0,0,0,17
1104033,26,4,3,0,0,0,0,33
1104034,50,3,4,4,0,0,0,61
1104035,25,4,6,0,0,0,0,35
1104036,32,8,3,0,0,0,0,43
1104037,22,3,3,0,0,0,0,28
1104038,30,3,3,0,0,0,0,36
1104039,50,7,6,0,0,0,3,66
1104040,30,3,0,0,3,0,0,36
1104041,20,3,3,0,0,0,0,26
1104042,21,3,0,0,0,0,4,28
1104043,32,4,0,0,0,0,4,40
1104044,20,3,3,3,0,0,0,29
1104045,34,4,7,0,0,0,0,45
1104046,38,5,4,0,0,0,0,47
1104047,37,7,0,0,0,0,0,44
1104048,50,6,3,0,0,0,0,59
1104049,40,5,4,0,0,0,0,49
1104050,25,5,4,0,0,0,0,34
1104051,46,0,0,0,0,0,3,49
1104052,39,7,4,0,0,0,3,53
1104053,40,3,0,0,0,0,0,43
1104054,31,4,5,0,0,0,0,40
1104055,68,3,3,3,0,0,0,77
1104056,48,3,5,0,0,0,0,56
1104057,62,3,3,0,0,0,0,68
1104058,39,0,0,0,0,0,0,39
1104101,53,0,0,0,0,0,0,53
1104102,79,4,0,0,0,0,0,83
1104103,41,6,0,0,0,0,0,47
1104104,50,6,4,0,0,0,0,60
1104105,48,8,3,0,0,0,0,59
1104106,49,5,3,0,0,0,0,57
1104107,28,4,0,0,0,0,0,32
1104108,0,0,0,0,0,0,0,0
1104109,34,0,0,3,0,0,0,37
1104110,65,4,4,0,0,0,0,73
1104111,31,3,0,0,0,0,0,34
1104112,48,3,3,0,0,0,0,54
1104113,46,4,0,0,0,0,0,50
1104114,54,10,3,0,0,0,0,67
1104115,28,7,0,0,0,0,0,35
1104116,63,0,0,0,0,0,0,63
1104117,25,3,0,0,0,0,0,28
1104118,0,0,0,0,0,0,0,0
1104119,58,7,0,0,0,0,0,65
1104120,52,8,3,0,0,0,0,63
1104121,39,3,3,3,0,0,0,48
1104122,36,9,5,0,0,0,0,50
1104123,48,3,3,0,0,0,0,54
1104124,50,6,3,0,0,0,0,59
1104125,45,3,3,5,0,0,0,56
1104201,44,4,3,0,0,0,0,51
1104202,52,7,0,0,0,0,0,59
1104203,35,0,0,0,0,0,0,35
1104204,11,0,3,4,0,0,0,18
1104205,25,4,3,0,0,0,0,32
1104206,0,0,0,0,0,0,0,0
1104207,72,7,3,0,0,0,0,82
1104208,34,4,0,0,0,0,0,38
1104209,13,5,4,0,0,0,0,22
1104210,47,12,5,0,0,0,0,64
1104211,44,3,0,0,0,0,0,47
1104212,0,3,0,0,0,0,0,3
1104213,41,4,5,0,0,0,0,50
1104214,34,5,0,3,0,0,0,42
1104215,37,0,0,0,0,0,0,37
1104216,31,5,0,0,0,0,0,36
1104217,29,4,0,0,0,0,0,33
1104218,44,0,4,0,0,0,3,51
1104219,34,3,0,4,0,0,0,41
1104220,32,6,0,0,0,0,0,38
1104221,28,3,3,0,0,0,0,34
1104222,30,6,0,0,0,0,0,36
1104223,23,7,3,0,0,0,0,33
1104224,54,3,7,0,0,0,0,64
1104225,55,6,6,0,0,0,0,67
1104226,33,0,4,0,0,0,0,37
1104227,30,3,3,0,0,0,0,36
1104228,48,6,3,0,0,0,0,57
1104229,13,3,3,0,0,0,0,19
1104230,29,3,3,0,0,0,0,35
1104231,25,4,3,0,0,0,3,35
1104232,21,3,3,0,0,0,0,27
1104233,21,4,3,0,0,0,0,28
1104301,8,0,0,0,0,0,0,8
1104302,30,3,3,0,0,0,0,36
1104303,48,6,13,0,0,0,0,67
1104304,42,4,0,0,0,0,0,46
1104305,41,10,4,0,0,0,0,55
1104306,0,0,0,0,0,0,0,0
1104307,45,0,3,0,0,0,0,48
1104308,34,0,0,0,0,0,0,34
1104309,47,0,0,0,0,0,0,47
1104310,17,0,5,0,0,0,0,22
1104311,45,10,0,0,0,0,0,55
1104312,4,0,0,0,0,0,0,4
1104313,9,3,3,0,3,0,0,18
1104314,0,0,0,0,0,0,0,0
1104315,52,4,0,0,0,0,3,59
1104316,29,5,0,0,0,0,4,38
1104317,33,7,0,0,0,0,0,40
1104318,21,0,0,0,0,0,0,21
1104319,50,3,3,0,0,0,0,56
1104320,48,3,0,0,0,0,0,51
1104321,31,3,3,0,0,0,0,37
1104322,30,3,8,0,0,0,0,41
1104323,48,5,3,0,0,0,0,56
1104324,61,8,6,0,0,0,0,75
1104325,35,0,0,0,0,0,0,35
1104326,68,7,6,0,0,0,0,81
1104327,48,7,0,0,0,0,0,55
1104328,27,3,0,0,0,0,0,30
1104329,22,6,3,0,0,0,0,31
1104330,52,5,3,0,0,0,0,60
1104401,35,5,0,0,0,0,0,40
1104402,43,3,3,3,0,0,0,52
1104403,19,3,0,0,0,0,0,22
1104404,73,13,3,0,0,0,0,89
1104405,32,4,0,0,0,0,0,36
1104406,35,0,3,0,0,0,0,38
1104407,45,3,3,0,0,0,0,51
1104408,24,0,3,0,0,0,0,27
1104409,27,3,4,0,0,0,0,34
1104410,0,0,0,0,0,0,0,0
1104411,11,3,0,0,0,0,0,14
1104412,47,3,0,0,0,0,0,50
1104413,0,0,0,0,0,0,0,0
1104414,55,4,5,0,0,0,0,64
1104415,46,0,0,0,0,0,0,46
1104416,60,7,5,0,0,0,0,72
1104417,34,9,3,0,0,3,3,52
1104418,0,0,0,0,0,0,0,0
1104419,52,4,9,0,0,0,0,65
1104420,9,0,0,0,0,0,0,9
1104421,18,0,0,0,0,0,0,18
1104422,49,3,3,3,0,0,0,58
1104423,52,3,3,0,0,0,0,58
1104424,24,3,4,0,0,0,0,31
1104425,23,3,0,0,0,3,0,29
1104426,39,8,0,0,0,0,0,47
1104427,22,0,0,0,0,0,0,22
1104428,40,5,0,0,0,0,0,45
1104429,46,4,0,0,0,0,5,55
1104430,23,0,3,0,0,0,0,26
1104431,32,6,0,0,0,0,0,38
1104432,13,0,5,0,0,0,3,21
1104433,34,3,3,0,0,0,3,43
1104434,43,6,11,0,0,0,0,60
1104435,53,6,0,0,0,0,0,59
1104436,45,6,0,0,0,0,0,51
1104437,29,0,0,0,0,0,0,29
1104438,41,3,0,0,0,0,0,44
1104439,41,4,3,0,0,0,0,48
1104440,0,0,0,0,0,0,0,0
1104441,39,3,3,0,0,0,0,45
1104442,38,6,3,3,0,0,0,50
1104443,17,4,0,0,0,0,3,24
1104444,27,3,3,0,0,0,0,33
1104445,28,4,4,0,0,0,0,36
1104446,16,4,5,0,0,0,0,25
1104447,32,3,3,0,0,0,0,38
1104448,31,3,7,0,0,0,3,44
1104449,32,0,3,0,0,0,0,35
1104450,51,7,3,0,0,0,0,61
1104451,44,4,8,0,0,0,0,56
1104452,7,5,0,0,0,0,0,12
1104453,34,3,4,0,0,0,0,41
1104454,21,0,0,0,0,0,0,21
1104455,39,6,3,0,0,0,0,48
1104456,48,0,0,0,0,0,0,48
1104457,42,7,0,4,0,0,0,53
1104458,39,8,0,0,0,0,0,47
1104459,46,3,0,0,0,0,0,49
1104501,42,6,3,0,0,0,0,51
1104502,43,3,0,0,0,0,0,46
1104503,28,3,5,0,0,0,0,36
1104504,57,3,13,0,0,0,0,73
1104505,38,5,3,0,0,0,3,49
1104506,59,6,6,0,0,0,0,71
1104507,52,4,5,0,0,0,0,61
1104508,40,5,6,0,0,0,0,51
1104509,42,0,5,0,0,0,0,47
1104510,52,6,8,0,0,0,0,66
1104511,54,8,7,4,0,0,0,73
1104512,34,0,8,3,0,0,0,45
1104513,60,11,9,0,0,0,0,80
1104514,45,7,9,0,0,0,0,61
1104515,36,6,3,0,0,0,0,45
1104516,57,6,6,3,3,0,3,78
1104517,31,5,3,0,0,0,0,39
1104518,67,9,4,4,0,0,0,84
1104519,32,3,5,0,0,0,0,40
1104520,0,0,0,0,0,0,0,0
1104521,46,9,3,0,0,0,3,61
1104522,32,7,8,4,0,0,0,51
1104523,36,4,4,0,0,0,0,44
1104524,51,7,8,0,0,0,0,66
1104601,34,0,3,0,0,0,3,40
1104602,25,3,3,0,0,0,0,31
1104603,44,3,3,3,0,0,0,53
1104604,31,6,3,0,0,0,0,40
1104605,15,0,6,0,0,0,0,21
1104606,34,0,0,0,0,0,0,34
1104607,44,9,3,0,0,0,0,56
1104608,39,7,9,3,0,0,0,58
1104609,45,5,3,0,0,0,3,56
1104610,17,4,3,0,0,0,0,24
1104611,9,0,0,0,0,0,0,9
1104612,27,0,3,0,0,0,0,30
1104613,0,0,0,0,0,0,0,0
1104614,26,3,6,4,0,0,0,39
1104615,19,4,3,0,0,0,0,26
1104616,36,3,3,3,0,0,3,48
1104617,15,8,0,0,0,0,0,23
1104618,38,13,4,0,0,0,0,55
1104619,30,4,0,0,3,0,0,37
1104620,35,4,3,0,0,0,0,42
1104621,26,4,3,0,3,0,0,36
1104622,28,0,3,0,0,0,0,31
1104623,0,0,0,0,0,0,0,0
1104624,39,5,0,0,0,0,0,44
1104625,43,7,5,0,0,0,0,55
1104701,59,6,3,0,0,0,0,68
1104702,26,0,0,0,0,0,0,26
1104703,24,3,3,3,0,0,0,33
1104704,75,4,6,0,0,0,3,88
1104705,59,0,4,0,0,0,0,63
1104706,51,3,3,0,0,0,3,60
1104707,60,7,4,0,0,0,0,71
1104708,68,9,9,0,0,0,0,86
1104709,48,6,3,0,0,0,3,60
1104710,8,0,3,0,0,0,0,11
1104711,21,4,0,0,0,0,0,25
1104712,65,5,4,3,0,0,0,77
1104713,46,3,5,0,0,0,0,54
1104714,30,0,0,0,0,0,0,30
1104715,53,8,0,0,0,0,0,61
1104716,52,5,5,0,0,0,0,62
1104717,42,3,3,0,0,0,0,48
1104718,31,3,3,0,0,0,0,37
1104719,66,7,0,3,0,0,3,79
1104720,35,9,0,0,0,0,0,44
1104721,74,5,0,0,0,0,0,79
1104722,64,4,3,0,0,0,0,71
1104723,42,3,0,0,0,0,0,45
1104724,43,5,0,0,0,0,0,48
1104725,30,3,4,0,3,0,0,40
1104726,35,4,3,0,0,0,0,42
1104727,45,0,3,0,0,0,0,48
1104728,61,7,4,0,0,0,0,72
1104729,62,3,5,0,0,0,0,70
1104730,33,0,6,0,0,0,0,39
1104731,59,11,9,0,0,0,0,79
1104732,39,8,3,0,0,0,3,53
1104733,14,0,3,0,0,0,3,20
1104734,31,0,4,0,0,0,0,35
1104735,57,11,3,0,0,0,0,71
1104736,53,11,3,3,0,0,0,70
1104737,0,0,0,0,0,0,0,0
1104801,25,3,3,0,0,0,3,34
1104802,35,4,3,0,0,0,3,45
1104803,57,3,8,3,0,0,3,74
1104804,37,0,4,3,0,0,0,44
1104805,31,3,4,0,0,3,3,44
1104806,29,5,0,0,0,0,0,34
1104807,65,4,0,0,0,0,0,69
1104808,20,3,0,0,0,0,0,23
1104809,25,0,3,0,0,0,4,32
1104810,23,9,3,0,0,0,0,35
1104811,50,10,3,0,3,0,3,69
1104812,39,6,3,0,0,0,0,48
1104813,44,3,6,3,0,0,0,56
1104814,57,4,6,0,0,0,0,67
1104815,15,4,5,0,0,0,0,24
1104816,25,5,0,0,0,0,0,30
1104817,42,4,3,0,0,0,3,52
1104818,49,4,6,0,0,0,0,59
1104819,40,6,8,4,0,0,0,58
1104820,14,0,0,0,0,0,0,14
1104821,12,4,3,0,0,0,0,19
1104822,52,7,4,0,0,0,0,63
1104823,24,4,3,0,0,0,0,31
1104824,43,4,11,0,0,0,0,58
1104825,31,3,4,0,0,0,0,38
1104826,24,7,3,0,0,0,0,34
1104827,51,14,0,0,0,0,0,65
1104828,39,8,6,0,0,0,0,53
1104829,22,5,3,3,0,0,3,36
1104830,30,7,3,0,0,0,0,40
1104831,46,3,3,3,0,0,0,55
1104832,46,4,4,0,0,0,3,57
1104833,27,5,6,0,0,0,0,38
1104834,28,4,0,0,0,3,0,35
1104835,16,3,3,0,0,0,3,25
1104836,45,8,3,3,0,0,0,59
1104837,42,8,4,0,0,3,0,57
1104838,30,8,4,0,0,0,0,42
1104839,58,5,3,0,0,0,0,66
1104840,35,6,0,0,0,0,0,41
1104841,33,6,0,0,0,0,3,42
1104842,30,7,0,0,0,0,0,37
1104843,23,4,3,0,0,0,0,30
1104844,34,3,0,0,0,0,0,37
1104845,26,4,3,0,0,0,0,33
1104846,25,4,3,0,0,0,0,32
1104847,20,5,7,0,0,0,0,32
1104901,62,4,4,0,0,0,0,70
1104902,45,0,3,0,0,0,0,48
1104903,47,0,0,0,0,0,0,47
1104904,37,4,0,0,0,0,0,41
1104905,52,3,3,0,0,0,0,58
1104906,28,3,0,3,0,0,0,34
1104907,24,0,4,0,0,0,0,28
1104908,23,0,0,0,0,0,0,23
1104909,0,0,0,0,0,0,0,0
1104910,35,3,5,0,0,3,3,49
1105001,52,9,0,3,0,0,0,64
1105002,39,0,3,3,0,0,0,45
1105003,49,10,4,0,0,0,0,63
1105004,40,3,3,0,0,0,0,46
1105005,49,5,0,0,0,0,0,54
1105006,38,3,3,0,0,0,0,44
1105007,40,6,0,0,0,0,4,50
1105008,46,0,3,0,0,0,0,49
1105009,47,3,4,0,0,0,0,54
1105010,28,0,0,0,0,0,0,28
1105011,39,5,6,0,0,0,0,50
1105012,33,5,0,0,0,0,0,38
1105013,37,3,3,0,0,0,0,43
1105014,0,0,0,0,0,0,0,0
1105015,23,0,3,0,0,0,0,26
1105016,0,0,0,0,0,0,0,0
1105017,7,0,0,0,0,0,0,7
1105018,30,4,0,0,0,0,0,34
1105019,35,5,0,3,0,0,0,43
1105020,0,0,0,3,0,0,0,3
1105021,0,0,0,0,0,0,0,0
1105022,49,5,4,0,0,0,0,58
1105023,24,4,0,0,0,0,0,28
1105024,21,3,3,0,0,0,0,27
1105025,26,3,6,0,0,0,0,35
1105026,37,7,5,0,0,0,0,49
1105101,75,5,4,3,0,0,0,87
1105102,31,3,3,5,0,0,0,42
1105103,28,4,0,0,0,0,0,32
1105104,25,5,0,0,0,0,0,30
1105105,0,0,0,0,0,0,0,0
1105106,47,3,3,0,0,0,0,53
1105107,11,0,0,0,0,0,0,11
1105108,60,3,3,0,0,0,0,66
1105109,28,4,3,0,0,0,0,35
1105110,44,5,4,4,0,0,0,57
1105111,32,3,0,0,0,0,0,35
1105112,27,3,5,0,0,0,0,35
1105113,34,0,6,0,0,0,4,44
1105114,43,4,3,4,0,0,0,54
1105115,33,3,3,0,0,0,0,39
1105116,32,7,0,0,0,0,0,39
1105201,41,3,3,3,0,0,0,50
1105202,71,9,0,3,0,0,0,83
1105203,29,3,3,0,0,0,3,38
1105204,49,5,3,0,0,0,0,57
1105205,47,7,3,0,0,0,3,60
1105206,30,5,0,0,0,0,0,35
1105207,33,4,5,0,0,0,0,42
1105208,23,6,0,0,0,0,0,29
1105209,29,7,7,0,0,0,0,43
1105210,23,4,3,0,0,0,4,34
1105211,0,0,0,0,0,0,0,0
1105212,0,0,0,0,0,0,0,0
1105213,15,5,4,0,0,0,0,24
1105214,26,0,3,0,0,0,3,32
1105215,25,0,3,0,0,0,0,28
1105216,35,4,8,0,0,0,3,50
1105301,16,0,0,0,0,0,0,16
1105302,14,3,0,0,0,0,0,17
1105303,23,0,3,0,0,0,0,26
1105304,23,5,4,0,0,0,0,32
1105305,40,7,5,0,0,0,0,52
1105306,48,4,0,0,0,0,0,52
1105307,25,3,3,0,0,0,0,31
1105308,14,6,0,0,0,0,0,20
1105309,34,0,0,3,0,0,0,37
1105310,25,3,0,0,0,0,3,31
1105311,12,0,5,0,0,0,0,17
1105312,29,3,0,0,0,0,0,32
1105313,13,3,0,0,0,0,0,16
1105314,17,3,3,3,0,0,0,26
1105315,38,9,3,3,0,0,0,53
1105316,33,8,0,3,0,0,0,44
1105317,16,4,3,0,0,0,0,23
1105318,17,3,5,0,0,0,0,25
1105319,12,4,0,3,0,0,0,19
1105320,18,7,4,0,0,0,0,29
1105321,30,10,10,0,0,0,0,50
1105322,11,0,0,0,0,0,0,11
1105323,0,0,0,0,0,0,0,0
1105324,45,6,3,0,0,0,0,54
1105325,26,0,0,0,0,0,4,30
1105326,40,3,3,0,0,0,0,46
1105327,9,3,3,0,0,0,0,15
1105328,15,10,3,0,0,0,3,31
1105329,17,5,0,4,0,0,0,26
1105330,12,4,0,0,0,0,0,16
1105331,22,3,0,0,0,0,0,25
1105332,17,3,0,0,0,0,0,20
1105333,6,4,3,0,0,0,0,13
1105334,24,3,4,0,0,0,0,31
1105335,21,3,0,0,0,0,0,24
1105336,18,4,0,0,0,0,0,22
1105337,34,4,5,3,0,0,0,46
1105401,38,3,0,0,0,0,0,41
1105402,12,0,3,0,0,0,0,15
1105403,10,7,0,0,0,0,0,17
1105404,12,5,0,0,0,0,0,17
1105405,20,4,0,0,0,0,0,24
1105406,7,0,0,0,0,0,0,7
1105407,50,7,3,0,0,0,0,60
1105408,72,11,0,0,0,0,0,83
1105409,29,0,3,0,0,0,0,32
1105410,33,3,0,0,0,0,0,36
1105411,30,3,3,0,0,0,0,36
1105412,36,4,0,4,0,0,0,44
1105413,33,5,4,0,0,0,0,42
1105414,35,0,3,0,0,0,0,38
1105415,0,0,0,0,0,0,0,0
1105416,0,0,0,0,0,0,0,0
1105417,24,3,0,0,0,0,0,27
1105418,27,8,0,0,0,3,0,38
1105419,22,4,3,0,0,0,0,29
1105420,36,3,0,0,0,0,0,39
1105421,30,0,4,0,0,0,0,34
1105422,31,3,3,0,0,0,0,37
1105423,45,7,0,0,0,0,0,52
1105424,24,3,0,0,0,0,0,27
1105501,26,7,3,0,0,0,0,36
1105502,69,8,3,0,0,0,0,80
1105503,25,3,4,0,0,0,0,32
1105504,0,0,0,0,0,0,0,0
1105505,56,4,3,0,0,0,0,63
1105506,31,3,5,0,0,0,0,39
1105507,57,9,3,0,0,0,0,69
1105508,39,5,0,3,0,0,0,47
1105509,47,0,0,0,0,0,0,47
1105510,30,4,0,0,0,0,0,34
1105511,75,3,4,0,3,0,0,85
1105512,26,4,0,0,0,0,0,30
1105513,32,3,0,0,0,0,0,35
1105514,27,4,0,0,0,0,0,31
1105601,67,4,5,3,0,0,0,79
1105602,83,14,3,3,0,0,0,103
1105603,79,3,8,0,0,0,3,93
1105604,32,4,4,0,0,0,0,40
1105605,57,12,3,3,0,0,3,78
1105606,47,3,0,0,0,0,0,50
1105607,66,6,7,3,0,0,0,82
1105608,59,7,5,0,0,0,0,71
1105609,24,0,0,0,0,0,0,24
1105610,73,10,9,0,0,0,0,92
1105611,87,9,7,4,0,0,0,107
1105612,55,5,3,3,0,0,0,66
1105613,75,10,4,0,0,0,0,89
1105614,53,3,7,0,0,0,3,66
1105615,62,10,0,0,0,0,0,72
1105616,0,0,0,0,0,0,0,0
1105617,28,0,7,0,0,0,0,35
1105618,87,5,3,0,0,0,0,95
1105619,111,8,6,0,0,0,0,125
1105620,34,0,5,0,0,0,4,43
1105621,0,0,0,0,0,0,0,0
1105622,42,9,3,0,0,0,0,54
1105623,55,0,4,0,0,0,0,59
1105624,39,6,3,4,0,0,0,52
1105625,26,4,0,0,0,0,0,30
1105626,32,3,5,0,0,0,0,40
1105627,67,3,5,3,0,0,0,78
1105701,66,6,6,0,0,0,0,78
1105702,49,5,3,3,0,0,0,60
1105703,51,9,9,0,0,0,0,69
1105704,38,7,6,0,0,0,0,51
1105705,4,0,0,0,0,0,0,4
1105706,26,3,4,0,0,0,0,33
1105707,41,3,6,0,0,0,0,50
1105708,34,6,0,0,0,0,0,40
1105709,49,8,4,0,0,0,0,61
1105710,34,4,0,0,0,0,0,38
1105711,33,0,5,0,0,0,0,38
1105712,27,7,0,0,0,0,0,34
1105713,17,4,0,0,0,0,0,21
1105714,28,5,4,0,0,0,0,37
1105715,13,7,0,4,0,0,0,24
1105716,36,3,3,0,0,0,0,42
1105717,45,6,7,0,0,0,0,58
1105718,18,0,3,0,0,0,3,24
1105719,23,3,3,0,0,0,0,29
1105720,22,3,0,0,0,0,0,25
1105801,44,3,3,0,0,0,0,50
1105802,42,3,0,0,0,0,0,45
1105803,70,3,0,0,0,0,0,73
1105804,43,8,3,0,0,0,0,54
1105805,19,0,0,0,0,0,0,19
1105806,60,0,3,0,0,0,0,63
1105807,18,6,0,0,0,0,0,24
1105808,11,3,0,0,0,0,0,14
1105809,17,0,4,0,0,0,0,21
1105810,98,8,4,0,0,0,0,110
1105811,52,3,3,0,0,0,0,58
1105812,93,3,5,0,0,0,0,101
1105813,58,0,3,0,0,0,0,61
1105814,19,0,0,0,0,0,0,19
1105815,38,6,3,0,0,0,0,47
1105816,31,3,3,0,0,0,0,37
1105817,21,4,0,0,0,0,0,25
1105818,44,3,0,0,0,0,0,47
1105819,26,4,0,0,0,0,0,30
1105820,3,3,0,0,0,0,0,6
1105821,26,3,0,0,0,0,0,29
1105822,15,0,0,0,0,0,0,15
1105823,30,3,4,3,0,0,0,40
1105824,25,0,0,0,0,0,0,25
1105825,20,0,3,0,0,0,0,23
1105826,86,5,6,0,0,0,0,97
1105827,13,6,3,0,0,0,3,25
1105828,21,4,0,3,0,0,0,28
1105829,16,0,4,3,0,0,3,26
1105830,18,4,4,0,0,0,0,26
1105831,22,0,4,0,0,0,0,26
1105832,34,3,3,0,0,0,0,40
1105833,16,5,0,0,0,0,0,21
1105834,33,4,0,0,0,0,0,37
1105835,40,4,3,0,0,0,0,47
1105836,17,4,4,0,0,0,0,25
1105837,33,5,0,0,0,0,0,38
1105838,39,4,3,0,0,0,0,46
1105839,74,3,5,0,0,0,0,82
1105840,54,3,5,0,0,0,0,62
1105841,0,0,0,0,0,0,0,0
1105842,52,7,3,0,0,0,0,62
1105843,29,6,0,0,0,0,0,35
1105844,50,3,0,0,0,0,0,53
1105845,47,7,3,0,0,0,0,57
1105846,33,0,5,0,0,0,0,38
1105847,41,5,0,0,0,0,0,46
1105848,35,0,3,0,0,0,0,38
1105849,0,0,0,0,0,0,0,0
1105850,19,4,4,0,0,0,0,27
1105851,34,0,4,0,0,0,0,38
1105852,0,0,0,0,0,0,0,0
1105853,25,0,4,0,0,0,0,29
1105854,26,3,3,5,0,0,0,37
1105855,24,3,7,0,0,0,0,34
1105856,19,0,3,0,0,0,0,22
1105857,19,3,0,0,0,0,0,22
1105901,37,6,3,0,0,0,0,46
1105902,34,6,0,0,0,0,0,40
1105903,31,3,0,0,0,0,0,34
1105904,0,0,0,0,0,0,0,0
1105905,26,11,4,0,0,0,0,41
1105906,16,5,3,0,0,0,0,24
1105907,18,5,5,0,0,0,0,28
1105908,8,3,0,0,0,0,3,14
1105909,122,15,6,3,0,3,0,149
1105910,40,3,3,0,0,0,3,49
1105911,26,3,3,0,0,0,0,32
1105912,22,0,3,0,0,3,0,28
1105913,60,3,3,0,0,0,3,69
1105914,25,7,3,0,0,0,0,35
1105915,40,0,0,5,0,0,0,45
1105916,71,4,0,0,0,0,0,75
1105917,97,11,3,0,0,0,0,111
1105918,35,9,3,0,0,0,0,47
1105919,82,5,0,0,0,0,0,87
1105920,29,3,3,0,0,0,0,35
1105921,35,4,4,0,0,0,0,43
1105922,46,6,0,0,0,0,0,52
1105923,73,16,7,0,3,0,0,99
1106001,23,0,0,0,0,0,0,23
1106002,25,0,0,0,0,0,0,25
1106003,25,0,4,0,0,0,0,29
1106004,51,5,3,0,0,0,0,59
1106005,23,3,0,3,0,0,3,32
1106006,67,5,3,0,0,3,3,81
1106007,18,3,0,0,0,0,0,21
1106008,43,6,0,3,0,0,0,52
1106009,40,0,4,0,0,0,0,44
1106010,46,7,0,0,0,0,0,53
1106011,40,3,3,0,0,0,0,46
1106012,41,4,3,0,0,0,0,48
1106013,33,3,3,0,0,0,0,39
1106014,28,3,0,4,0,0,0,35
1106015,33,0,0,0,0,0,0,33
1106016,48,5,3,0,0,0,0,56
1106017,27,3,0,0,0,0,0,30
1106018,34,3,0,0,0,0,0,37
1106019,39,6,0,0,0,0,0,45
1106020,25,3,3,0,0,0,0,31
1106021,0,0,0,0,0,0,0,0
1106101,17,3,0,0,0,0,0,20
1106102,46,0,0,0,0,0,0,46
1106103,54,0,0,0,0,0,0,54
1106104,21,3,3,0,0,0,0,27
1106105,20,4,4,0,0,0,0,28
1106106,30,5,0,0,0,0,0,35
1106107,9,3,0,0,0,0,3,15
1106108,44,6,0,3,0,0,0,53
1106109,9,0,0,0,0,0,0,9
1106110,27,0,0,0,0,0,0,27
1106111,22,4,5,0,0,0,0,31
1106112,39,7,3,0,0,0,0,49
1106113,0,0,0,0,0,0,0,0
1106114,34,0,3,0,0,0,0,37
1106115,22,3,0,0,0,0,4,29
1106116,29,3,3,0,0,0,0,35
1106201,37,0,0,0,0,0,3,40
1106202,24,0,3,0,0,0,5,32
1106203,36,0,0,0,0,0,0,36
1106204,26,9,3,0,0,0,0,38
1106205,38,0,0,0,0,0,0,38
1106206,35,0,0,6,0,0,0,41
1106207,28,0,0,3,0,0,0,31
1106208,17,0,0,0,0,0,0,17
1106209,27,0,0,0,0,0,4,31
1106210,29,0,3,4,0,0,0,36
1106211,18,3,3,5,0,0,0,29
1106212,14,0,0,3,0,0,3,20
1106213,44,3,3,3,0,0,0,53
1106214,34,4,0,0,0,0,0,38
1106215,29,3,3,0,0,0,0,35
1106216,12,0,0,0,0,0,0,12
1106217,41,0,0,0,0,0,0,41
1106218,36,0,5,0,0,0,0,41
1106219,54,4,0,0,0,0,0,58
1106220,35,4,0,0,0,0,0,39
1106221,26,0,0,0,0,0,0,26
1106222,17,0,3,0,0,0,0,20
1106223,0,0,0,0,0,0,0,0
1106224,4,0,0,0,0,0,0,4
1106225,0,0,0,0,0,0,0,0
1106301,0,0,0,0,0,0,0,0
1106302,0,0,0,0,0,0,0,0
1106303,29,8,3,0,0,0,0,40
1106304,78,5,4,0,0,0,0,87
1106305,23,8,0,0,0,0,0,31
1106306,14,0,0,0,0,0,0,14
1106307,0,0,0,0,0,0,0,0
1106308,27,0,7,0,0,4,0,38
1106309,34,3,3,3,0,0,0,43
1106310,30,6,0,4,0,0,0,40
1106311,29,3,4,0,0,0,0,36
1106312,19,4,0,0,0,0,0,23
1106313,20,0,3,0,0,0,0,23
1106314,22,0,0,0,0,0,0,22
1106315,40,9,0,0,0,0,0,49
1106316,19,4,0,0,0,0,0,23
1106317,24,3,3,0,0,0,0,30
1106318,9,4,5,0,0,0,0,18
1106319,14,0,0,0,0,0,0,14
1106320,8,0,0,0,0,0,0,8
1106321,22,4,4,0,0,0,0,30
1106322,27,0,0,0,0,0,0,27
1106323,40,6,3,0,0,0,0,49
1106324,25,3,4,0,0,0,0,32
1106325,38,11,3,0,0,0,0,52
1106326,26,3,0,0,0,0,0,29
1106327,26,0,0,0,0,0,0,26
1106328,58,5,0,0,0,0,0,63
1106329,22,0,0,0,0,0,0,22
1106401,13,0,3,0,0,0,0,16
1106402,22,4,0,0,0,0,0,26
1106403,24,5,0,0,0,0,0,29
1106404,21,0,0,0,0,0,0,21
1106405,20,4,0,0,0,0,0,24
1106406,21,0,4,0,0,0,0,25
1106407,53,4,0,0,0,0,0,57
1106408,52,3,3,0,0,0,4,62
1106409,24,3,3,0,0,0,0,30
1106410,32,3,3,0,0,0,0,38
1106411,27,3,3,0,0,0,0,33
1106412,27,0,3,0,0,0,0,30
1106413,33,3,3,0,0,0,0,39
1106414,29,0,0,0,0,0,0,29
1106415,13,0,3,0,0,0,3,19
1106416,14,0,0,0,0,0,0,14
1106417,29,6,0,0,0,0,0,35
1106418,20,0,4,0,0,0,0,24
1106501,18,4,0,0,0,0,0,22
1106502,19,3,0,0,0,0,0,22
1106503,20,0,3,0,0,0,3,26
1106504,39,3,0,0,0,0,3,45
1106505,14,5,0,0,0,0,0,19
1106506,29,6,3,0,0,0,0,38
1106507,29,3,0,3,0,0,0,35
1106508,44,0,0,0,0,0,0,44
1106509,42,3,3,0,0,3,0,51
1106510,29,0,4,0,0,0,0,33
1106511,46,3,4,3,0,0,0,56
1106512,31,3,3,0,0,0,0,37
1106513,27,3,0,0,0,0,0,30
1106514,19,0,8,0,0,0,0,27
1106515,40,4,3,0,0,0,0,47
1106516,20,0,0,0,0,0,4,24
1106517,17,3,0,0,0,0,0,20
1106518,28,3,0,0,0,0,0,31
1106519,32,4,0,0,0,0,0,36
1106520,34,3,0,3,0,0,0,40
1106521,33,0,0,0,0,0,0,33
1106522,25,0,0,0,0,0,0,25
1106523,30,0,3,0,0,0,0,33
1106524,18,4,0,0,0,0,0,22
1106525,20,0,3,0,0,0,0,23
1106526,33,5,3,0,0,0,3,44
1106527,14,0,3,0,0,0,0,17
1106528,33,5,3,0,0,0,3,44
1106529,21,3,0,0,0,0,0,24
1106601,9,0,4,0,0,0,0,13
1106602,20,4,0,0,0,0,0,24
1106603,30,0,3,0,0,0,3,36
1106604,35,0,3,0,0,0,0,38
1106605,33,0,0,0,0,0,0,33
1106606,19,5,0,0,0,0,0,24
1106607,28,0,4,0,0,0,0,32
1106608,14,5,0,0,0,0,0,19
1106609,15,0,0,0,0,0,0,15
1106610,29,4,0,0,0,0,4,37
1106611,33,4,0,3,0,0,0,40
1106612,32,0,0,0,0,0,0,32
1106613,17,3,0,0,0,0,0,20
1106701,23,4,4,0,0,0,0,31
1106702,54,3,0,0,0,0,3,60
1106703,40,0,0,0,0,0,0,40
1106704,20,0,0,0,0,0,0,20
1106705,32,3,4,0,0,0,3,42
1106706,39,0,0,0,0,0,0,39
1106707,40,3,8,0,0,3,0,54
1106708,53,3,3,0,0,0,0,59
1106709,23,0,3,0,0,0,3,29
1106710,66,4,0,0,0,0,0,70
1106711,21,0,3,0,0,0,0,24
1106712,34,0,0,0,0,0,0,34
1106713,40,4,0,0,0,0,0,44
1106714,30,3,3,3,0,0,0,39
1106715,47,0,3,0,0,0,0,50
1106716,40,4,0,0,0,0,3,47
1106717,19,0,3,0,0,0,4,26
1106718,43,0,5,0,0,0,0,48
1106719,30,3,5,0,0,3,3,44
1106720,24,3,6,0,0,0,0,33
1106721,20,0,3,0,0,0,0,23
1106722,15,0,3,0,0,0,0,18
1106723,48,4,4,0,0,0,0,56
1106724,31,7,3,0,0,0,0,41
1106725,30,3,5,0,0,0,0,38
1106726,37,8,6,0,0,0,0,51
1106727,17,3,7,0,0,0,3,30
1106728,10,0,0,0,0,0,0,10
1106729,49,4,4,0,0,0,0,57
1106801,18,3,0,0,0,0,0,21
1106802,19,3,0,0,0,0,0,22
1106803,9,3,3,0,0,0,0,15
1106804,8,0,4,0,0,0,0,12
1106805,29,3,0,0,0,0,0,32
1106806,27,0,5,0,0,0,0,32
1106807,24,0,3,0,0,0,3,30
1106808,49,3,0,0,0,0,0,52
1106809,40,0,4,0,0,0,0,44
1106810,33,0,0,8,0,0,0,41
1106811,39,3,0,0,0,0,0,42
1106901,24,0,6,0,0,0,0,30
1106902,50,4,5,0,0,0,3,62
1106903,20,0,0,0,0,0,0,20
1106904,47,3,3,0,0,0,0,53
1106905,28,3,3,0,0,0,0,34
1106906,41,0,0,0,0,0,0,41
1106907,34,0,3,0,0,0,3,40
1106908,30,4,0,0,0,0,0,34
1106909,20,0,4,0,0,0,0,24
1106910,38,3,3,0,0,0,0,44
1106911,11,3,3,0,0,0,0,17
1106912,18,0,3,0,0,0,3,24
1106913,24,0,4,3,0,0,0,31
1106914,37,0,4,0,0,0,0,41
1106915,24,0,4,0,0,0,0,28
1106916,26,7,0,3,0,0,0,36
1106917,21,0,0,0,0,0,0,21
1106918,25,0,4,0,0,0,0,29
1106919,29,3,5,0,0,0,0,37
1107001,70,4,3,0,0,0,0,77
1107002,15,0,0,0,0,0,0,15
1107003,39,5,0,0,0,0,0,44
1107004,16,0,0,0,0,0,0,16
1107005,42,3,7,0,0,0,0,52
1107006,34,3,3,3,0,0,0,43
1107007,8,7,3,0,0,0,0,18
1107008,19,0,3,0,0,0,0,22
1107009,0,0,0,0,0,0,0,0
1107010,37,4,0,0,0,0,0,41
1107011,30,6,4,0,0,0,0,40
1107012,36,4,3,0,0,0,0,43
1107013,22,3,3,3,3,0,0,34
1107014,50,4,4,0,0,0,0,58
1107015,29,3,3,0,0,3,0,38
1107016,23,0,0,0,0,0,0,23
1107017,42,0,4,0,0,0,0,46
1107018,54,5,3,0,0,0,0,62
1107019,33,4,3,0,0,0,0,40
1107020,30,5,3,0,0,0,0,38
1107021,37,4,3,0,0,0,3,47
1107022,21,0,4,0,0,0,0,25
1107023,23,4,4,0,0,0,0,31
1107024,21,4,0,0,0,0,0,25
1107025,25,3,0,0,0,0,0,28
1107026,27,3,3,0,0,0,0,33
1107027,55,3,3,0,0,0,0,61
1107028,49,0,4,0,0,0,0,53
1107029,28,0,0,0,0,0,0,28
1107030,32,3,3,0,0,0,0,38
1107031,0,0,0,0,0,0,0,0
1107032,36,6,3,3,0,0,0,48
1107101,11,3,0,0,0,0,0,14
1107102,28,3,3,0,0,3,0,37
1107103,34,0,0,0,0,0,0,34
1107104,19,0,3,0,0,0,0,22
1107105,28,3,7,3,0,0,0,41
1107106,54,3,3,3,0,0,0,63
1107107,52,4,5,4,0,0,0,65
1107108,19,0,7,0,0,0,0,26
1107109,26,3,3,0,0,0,0,32
1107110,37,0,0,0,0,0,0,37
1107111,25,3,0,0,0,0,0,28
1107112,33,0,3,0,0,0,0,36
1107113,27,0,0,0,0,0,0,27
1107114,25,4,0,0,0,0,0,29
1107115,32,3,3,0,0,0,0,38
1107116,30,5,3,0,0,0,3,41
1107117,29,5,3,0,0,0,0,37
1107118,0,0,0,0,0,0,0,0
1107119,30,5,3,0,0,0,0,38
1107120,33,3,3,0,0,0,0,39
1107121,17,3,3,0,0,0,0,23
1107122,34,0,3,0,0,0,0,37
1107123,15,0,0,0,0,0,0,15
1107124,26,4,0,0,0,0,0,30
1107125,22,3,0,0,0,0,0,25
1107126,9,0,0,0,0,0,0,9
1107127,22,5,0,0,0,0,0,27
1107128,27,0,3,0,0,3,0,33
1107201,17,7,3,0,0,0,0,27
1107202,31,5,6,0,0,0,0,42
1107203,21,4,0,0,0,0,0,25
1107204,24,5,9,0,0,0,0,38
1107205,29,4,3,0,0,0,0,36
1107206,37,3,0,0,0,0,0,40
1107207,14,3,0,3,0,0,0,20
1107208,36,3,3,0,0,3,0,45
1107209,22,7,0,0,0,0,0,29
1107210,22,4,3,0,0,0,0,29
1107211,72,0,5,0,0,0,0,77
1107212,35,6,4,0,0,0,0,45
1107213,114,9,11,0,0,0,0,134
1107214,39,3,0,0,0,0,0,42
1107215,32,4,0,0,0,0,0,36
1107216,52,3,0,0,0,0,3,58
1107217,55,5,3,0,0,0,0,63
1107218,51,3,0,0,0,0,0,54
1107219,55,7,3,0,0,0,0,65
1107220,36,4,4,0,0,0,0,44
1107221,34,0,0,0,0,0,0,34
1107222,29,3,0,0,0,0,0,32
1107223,83,5,3,0,0,0,0,91
1107224,28,7,6,0,0,0,0,41
1107301,0,0,0,0,0,0,0,0
1107302,29,3,0,0,0,0,0,32
1107303,30,4,5,0,0,0,0,39
1107304,13,0,5,0,0,0,0,18
1107305,14,3,0,0,0,0,0,17
1107306,19,0,0,0,0,0,3,22
1107307,22,3,3,3,0,0,4,35
1107308,18,0,3,0,0,0,0,21
1107309,15,3,4,0,0,0,0,22
1107310,22,3,3,0,0,0,0,28
1107311,15,3,4,0,0,0,0,22
1107312,19,0,3,0,0,0,3,25
1107313,13,3,0,0,0,0,0,16
1107314,19,6,0,0,0,0,3,28
1107401,22,7,0,0,0,0,3,32
1107402,35,0,3,0,0,0,0,38
1107403,52,0,3,0,0,0,0,55
1107404,53,3,0,0,0,0,0,56
1107405,27,4,0,0,0,0,0,31
1107406,17,3,0,0,0,0,0,20
1107407,29,4,4,5,0,0,0,42
1107408,27,0,0,0,0,0,0,27
1107409,38,7,3,0,0,0,3,51
1107410,18,0,3,0,0,0,0,21
1107411,45,4,3,0,0,0,0,52
1107412,44,4,6,0,0,0,0,54
1107413,34,3,3,0,0,0,0,40
1107414,39,5,3,0,0,0,0,47
1107415,46,3,0,3,0,0,0,52
1107416,46,4,0,0,0,0,3,53
1107417,30,5,0,0,0,0,0,35
1107418,35,0,0,0,0,0,0,35
1107419,36,3,3,0,0,0,0,42
1107420,44,4,0,0,0,0,0,48
1107421,41,5,3,3,0,0,0,52
1107422,38,0,0,0,0,0,0,38
1107423,22,0,3,0,0,0,3,28
1107424,44,7,0,0,0,0,0,51
1107425,28,8,3,0,0,0,3,42
1107426,20,0,0,3,3,0,0,26
1107501,0,0,0,0,0,0,0,0
1107601,27,3,0,0,0,0,0,30
1107602,27,0,3,0,0,0,0,30
1107603,39,6,6,0,0,0,0,51
1107604,29,5,0,0,0,0,0,34
1107605,52,5,0,0,0,0,0,57
1107606,42,4,0,0,0,0,3,49
1107607,21,0,4,0,0,0,0,25
1107608,42,3,3,0,0,0,0,48
1107609,31,4,4,0,0,0,0,39
1107610,35,0,3,0,0,0,0,38
1107611,15,4,0,0,0,0,0,19
1107612,15,0,0,0,0,0,0,15
1107613,20,0,4,0,0,0,0,24
1107614,49,0,5,0,0,0,0,54
1107615,57,9,0,0,0,0,0,66
1107616,50,0,12,0,0,0,0,62
1107617,42,0,6,0,0,0,0,48
1107618,19,3,0,0,0,0,0,22
1107619,25,3,0,0,0,0,0,28
1107620,13,4,0,0,0,0,0,17
1107621,37,6,0,0,0,0,0,43
1107701,37,3,0,0,0,0,0,40
1107702,28,3,0,0,0,0,0,31
1107703,24,4,0,0,0,0,0,28
1107704,16,3,3,0,0,0,0,22
1107705,7,3,0,0,0,0,0,10
1107706,16,0,0,3,0,0,0,19
1107707,39,3,0,0,0,0,0,42
1107708,60,3,3,0,0,0,0,66
1107709,38,4,0,0,0,0,0,42
1107710,15,0,5,0,3,0,3,26
1107711,28,3,0,0,0,0,0,31
1107712,24,3,0,0,0,0,0,27
1107713,36,4,0,0,0,0,0,40
1107714,18,5,0,0,0,0,0,23
1107715,45,5,0,0,0,0,0,50
1107716,56,0,3,0,0,0,0,59
1107717,52,3,3,0,0,0,0,58
1107718,38,0,4,0,0,0,0,42
1107719,25,4,4,0,0,0,0,33
1107720,28,4,0,0,0,0,0,32
1107721,31,3,0,0,0,0,0,34
1107722,27,0,4,3,0,0,0,34
1107723,37,4,3,3,0,0,0,47
1107724,11,0,3,3,0,3,0,20
1107725,26,0,3,0,0,0,3,32
1107726,39,4,0,0,0,0,0,43
1107727,30,3,8,0,0,0,0,41
1107728,36,0,4,0,0,0,0,40
1107729,36,4,3,3,0,0,0,46
1107730,33,7,3,0,0,0,0,43
1107731,52,7,0,0,0,0,0,59
1107732,25,0,5,0,0,0,0,30
1107733,28,7,3,0,0,0,3,41
1107734,13,4,0,0,0,0,0,17
1107735,0,0,0,0,0,0,0,0
1107736,14,0,0,0,0,0,0,14
1107737,24,0,0,0,0,0,0,24
1107738,22,0,0,0,0,0,0,22
1107739,5,0,0,3,0,0,0,8
1107740,65,5,6,0,0,0,0,76
1107741,11,3,0,0,0,0,0,14
1107742,16,7,0,0,0,0,0,23
1107743,10,5,0,0,0,0,0,15
1107744,19,3,0,3,0,0,0,25
1107745,24,5,3,0,0,0,0,32
1107746,43,0,4,0,0,0,0,47
1107747,17,5,7,0,0,0,0,29
1107748,32,0,0,0,0,0,0,32
1107749,14,4,3,0,0,0,0,21
1107750,24,3,4,0,0,0,0,31
1107751,20,3,0,0,0,0,0,23
1107752,33,7,5,0,0,0,0,45
1107753,24,0,0,3,0,3,0,30
1107754,49,5,0,0,0,0,0,54
1107801,37,0,3,0,0,0,0,40
1107802,23,0,0,0,0,0,0,23
1107803,74,5,3,0,0,0,0,82
1107804,42,3,0,0,0,0,0,45
1107805,24,5,4,0,0,0,0,33
1107806,55,3,3,0,0,0,0,61
1107807,42,0,3,0,0,0,3,48
1107808,22,4,10,0,0,0,0,36
1107809,27,0,0,0,0,0,0,27
1107810,32,3,3,0,0,0,0,38
1107811,38,0,7,0,0,0,0,45
1107812,57,0,3,3,0,0,0,63
1107813,34,0,3,0,0,0,0,37
1107814,48,3,3,3,0,0,0,57
1107815,34,6,4,0,0,0,0,44
1107816,49,6,0,0,0,0,0,55
1107817,77,3,6,0,0,0,0,86
1107818,62,9,4,3,0,3,0,81
1107819,37,0,3,0,0,0,0,40
1107820,34,3,0,0,0,0,0,37
1107821,30,0,0,0,0,0,0,30
1107822,61,7,3,0,0,0,0,71
1107823,48,5,0,0,0,0,0,53
1107824,45,9,0,0,0,0,0,54
1107825,39,3,0,0,0,0,0,42
1107826,60,3,3,0,0,0,0,66
1107827,77,5,4,0,0,0,0,86
1107828,57,0,0,0,0,0,0,57
1107829,16,5,0,0,0,0,0,21
1107830,43,3,3,0,0,0,0,49
1107831,54,6,0,0,0,0,0,60
1107832,164,7,16,0,0,0,0,187
1107833,82,7,3,0,0,0,0,92
1107834,103,3,0,0,0,0,0,106
1107835,53,3,0,0,0,0,0,56
1107836,48,3,3,0,0,0,0,54
1107837,17,7,3,0,0,0,0,27
1107838,25,3,0,0,0,0,0,28
1107839,25,0,5,0,0,0,0,30
1107901,18,4,3,0,0,0,0,25
1107902,39,3,0,0,0,0,0,42
1107903,28,3,3,0,3,0,0,37
1107904,39,3,3,0,0,0,0,45
1107905,23,0,0,0,0,0,0,23
1107906,18,3,4,0,0,0,0,25
1107907,34,3,3,0,0,0,0,40
1107908,38,0,4,0,0,0,0,42
1107909,32,4,0,0,0,0,0,36
1107910,23,0,0,0,0,0,0,23
1107911,36,3,0,3,0,0,0,42
1107912,33,0,0,0,0,0,0,33
1107913,46,6,3,0,0,0,0,55
1107914,36,7,0,0,0,0,0,43
1107915,37,3,4,0,0,0,0,44
1107916,29,0,0,0,0,0,0,29
1107917,28,3,0,0,0,0,0,31
1107918,27,0,6,0,0,0,0,33
1107919,37,4,0,0,0,0,0,41
1107920,16,3,3,0,0,0,0,22
1107921,23,3,0,0,3,0,0,29
1107922,46,0,3,0,0,0,0,49
1107923,12,0,3,0,0,0,3,18
1107924,77,5,3,0,0,0,0,85
1107925,74,4,4,0,0,0,0,82
1107926,20,0,0,0,0,0,0,20
1107927,43,3,4,0,0,0,0,50
1107928,52,4,4,0,0,0,0,60
1107929,67,3,5,0,0,0,0,75
1107930,55,3,0,0,0,0,0,58
1107931,19,0,3,0,0,0,0,22
1107932,27,0,0,0,0,0,0,27
1107933,11,3,0,0,0,0,0,14
1107934,42,3,3,0,0,0,0,48
1107935,29,6,3,0,0,0,0,38
1107936,44,3,0,4,0,0,0,51
1108001,28,5,4,0,0,0,0,37
1108002,3,0,0,0,0,0,0,3
1108003,30,0,5,0,0,0,0,35
1108004,0,0,0,0,0,0,0,0
1108005,8,3,0,0,0,0,0,11
1108006,44,3,3,0,0,0,0,50
1108007,27,4,4,0,0,0,0,35
1108008,15,0,8,3,0,0,0,26
1108009,16,0,3,3,0,0,3,25
1108010,37,3,3,3,0,0,0,46
1108011,26,5,3,3,0,0,0,37
1108012,43,3,4,0,0,0,0,50
1108013,6,0,3,0,0,0,0,9
1108014,25,4,5,0,0,0,0,34
1108015,48,4,0,0,0,0,0,52
1108016,32,0,4,0,0,3,0,39
1108017,46,7,0,0,0,0,0,53
1108018,19,0,0,0,0,0,0,19
1108019,28,10,3,3,3,0,0,47
1108020,24,3,3,0,0,0,0,30
1108021,28,3,7,0,0,0,0,38
1108022,24,0,3,0,0,0,0,27
1108023,22,3,0,3,0,0,0,28
1108024,20,3,0,0,0,0,0,23
1108025,39,3,3,0,0,0,0,45
1108026,0,0,0,0,0,0,0,0
1108027,45,0,0,0,0,0,0,45
1108028,34,3,0,0,0,0,0,37
1108029,46,4,5,5,0,0,0,60
1108030,45,3,3,0,0,0,0,51
1108031,17,3,3,0,0,0,0,23
1108032,8,7,0,0,0,0,0,15
1108033,39,0,0,0,0,0,0,39
1108034,29,0,3,0,0,0,4,36
1108035,49,0,3,0,0,0,0,52
1108036,20,0,0,0,0,0,0,20
1108037,26,4,5,0,0,0,0,35
1108038,13,0,3,0,0,3,3,22
1108039,42,4,4,0,0,0,0,50
1108040,55,3,4,0,0,0,3,65
1108041,21,3,0,0,0,0,0,24
1108042,24,0,4,0,0,0,0,28
1108043,39,3,5,0,0,0,0,47
1108044,49,4,0,0,0,0,4,57
1108045,40,3,0,3,0,0,4,50
1108046,17,0,0,0,0,0,0,17
1108047,14,3,3,0,0,3,0,23
1108048,24,4,3,3,0,0,0,34
1108049,10,4,0,0,0,0,0,14
1108050,25,3,3,0,0,0,0,31
1108051,0,0,0,0,0,0,0,0
1108101,20,0,3,3,0,0,0,26
1108102,27,0,0,0,0,0,0,27
1108103,13,3,3,0,0,0,0,19
1108104,17,0,0,3,0,0,3,23
1108105,34,3,0,0,0,0,0,37
1108106,27,3,0,0,0,0,0,30
1108107,17,0,4,0,0,0,0,21
1108108,39,7,0,0,0,0,0,46
1108109,24,3,3,0,0,0,0,30
1108110,22,3,0,0,0,0,0,25
1108111,0,0,0,0,0,0,0,0
1108112,20,3,3,0,0,0,0,26
1108113,31,0,5,0,0,0,0,36
1108114,39,4,6,0,0,0,0,49
1108115,30,0,3,0,0,0,0,33
1108116,27,3,0,3,0,0,0,33
1108117,39,0,0,0,0,0,0,39
1108118,43,0,0,0,0,0,0,43
1108119,11,0,0,0,0,0,0,11
1108120,26,4,0,0,0,0,0,30
1108121,23,0,0,3,0,0,0,26
1108122,19,3,0,0,0,0,0,22
1108123,25,0,0,0,0,0,0,25
1108124,38,3,3,3,0,0,0,47
1108125,20,0,3,0,0,0,3,26
1108126,20,0,6,0,0,0,0,26
1108127,20,0,3,0,0,0,0,23
1108128,26,3,5,0,0,0,0,34
1108129,24,7,3,4,0,0,0,38
1108130,26,4,0,0,0,0,0,30
1108131,37,3,3,3,0,0,0,46
1108132,23,3,0,3,0,0,0,29
1108133,18,3,3,0,0,0,3,27
1108134,63,0,5,0,0,0,0,68
1108135,53,3,7,0,0,0,0,63
1108136,38,3,0,0,0,0,0,41
1108137,22,0,4,0,0,0,0,26
1108138,22,4,4,0,0,0,0,30
1108139,26,0,3,4,0,0,0,33
1108140,20,6,0,3,0,0,0,29
1108141,32,0,3,0,0,0,0,35
1108142,43,3,4,0,0,0,0,50
1108143,38,0,4,0,0,3,0,45
1108144,30,5,3,0,0,0,0,38
1108145,25,0,3,0,0,0,0,28
1108146,43,5,3,0,0,0,3,54
1108147,20,0,4,0,0,0,0,24
1108148,3,3,3,0,0,0,0,9
1108149,14,0,0,0,0,0,0,14
1108150,19,0,0,0,0,0,0,19
1108201,3,0,0,0,0,0,3,6
1108202,19,0,0,0,3,0,0,22
1108203,39,3,0,0,0,0,0,42
1108204,48,7,0,0,0,0,0,55
1108205,17,5,3,0,0,0,0,25
1108206,5,0,0,0,0,0,0,5
1108207,60,6,6,0,0,0,0,72
1108208,15,3,0,0,0,0,0,18
1108209,11,4,0,0,0,0,0,15
1108210,0,0,0,0,0,0,0,0
1108211,32,0,5,0,0,0,0,37
1108212,22,3,0,0,0,0,0,25
1108213,36,0,4,0,0,0,0,40
1108214,36,5,0,0,0,3,0,44
1108215,20,7,0,0,0,0,0,27
1108216,26,4,0,0,0,0,4,34
1108217,8,4,0,0,0,0,0,12
1108218,21,0,5,0,0,0,0,26
1108219,24,5,0,0,0,0,0,29
1108220,16,3,0,0,0,0,0,19
1108221,30,9,0,0,0,0,0,39
1108222,21,0,0,0,0,0,0,21
1108223,20,0,5,0,0,0,0,25
1108224,28,6,6,0,0,0,0,40
1108225,22,0,0,4,0,0,0,26
1108226,20,3,0,0,0,0,0,23
1108227,21,0,0,0,0,0,0,21
1108228,13,3,3,0,0,0,0,19
1108229,18,0,0,0,0,0,0,18
1108230,28,4,5,0,0,0,0,37
1108231,26,7,4,0,0,0,0,37
1108232,38,3,0,3,0,0,0,44
1108233,38,4,0,0,0,0,4,46
1108234,40,4,3,0,0,0,0,47
1108235,30,4,3,0,0,0,0,37
1108236,0,0,0,0,0,0,0,0
1108237,30,5,0,0,0,0,0,35
1108238,45,0,0,0,0,0,0,45
1108239,31,0,0,0,0,0,0,31
1108240,44,4,0,0,0,0,0,48
1108241,19,4,3,0,0,0,0,26
1108242,20,3,0,0,0,0,4,27
1108243,22,0,3,0,0,0,0,25
1108244,25,0,0,0,0,0,0,25
1108245,53,3,0,0,0,0,0,56
1108301,40,11,0,0,0,0,3,54
1108302,16,3,0,3,0,0,0,22
1108303,40,6,4,0,0,0,0,50
1108304,23,5,0,0,0,0,0,28
1108305,23,10,4,0,0,0,0,37
1108306,13,3,0,0,0,0,0,16
1108307,33,0,3,0,0,0,0,36
1108308,30,3,4,0,0,0,0,37
1108309,47,3,0,0,0,0,0,50
1108310,41,5,0,0,0,0,0,46
1108311,13,3,0,0,0,0,0,16
1108312,33,0,0,0,0,0,0,33
1108313,25,3,0,0,0,0,0,28
1108314,41,0,5,0,0,0,0,46
1108315,26,3,7,0,0,0,0,36
1108316,17,0,3,0,0,0,3,23
1108317,46,0,0,0,0,0,0,46
1108401,32,0,3,0,0,0,0,35
1108402,0,0,0,0,0,0,0,0
1108403,9,3,0,0,0,0,0,12
1108404,33,6,3,0,0,0,3,45
1108405,22,3,0,0,0,0,0,25
1108406,31,3,3,3,0,0,0,40
1108407,35,4,3,0,0,0,0,42
1108408,16,3,0,3,0,0,0,22
1108409,52,3,3,0,0,0,0,58
1108410,32,3,6,0,0,0,0,41
1108411,11,0,0,0,0,0,0,11
1108412,25,3,3,0,0,0,0,31
1108413,46,4,4,0,0,0,0,54
1108414,41,5,0,0,0,0,0,46
1108415,40,3,3,0,0,0,0,46
1108416,36,3,0,0,0,0,0,39
1108417,24,4,0,0,0,4,0,32
1108418,27,3,3,0,0,0,3,36
1108419,45,3,0,0,0,0,0,48
1108420,15,0,0,0,0,0,0,15
1108421,33,3,3,0,0,0,0,39
1108422,14,0,0,0,0,0,3,17
1108423,13,0,3,0,0,0,0,16
1108424,6,0,4,0,0,0,0,10
1108425,35,3,0,0,0,0,0,38
1108426,36,4,0,4,0,0,0,44
1108427,56,5,3,3,0,0,3,70
1108428,22,0,0,0,0,0,4,26
1108429,16,3,0,3,0,0,0,22
1108430,56,5,3,0,0,0,0,64
1108431,29,5,4,0,0,0,0,38
1108432,22,5,0,0,0,0,0,27
1108433,26,3,3,0,0,0,3,35
1108434,7,4,0,0,0,0,0,11
1108435,11,0,3,3,0,0,0,17
1108436,19,3,3,0,0,0,0,25
1108437,28,4,0,0,0,0,0,32
1108438,39,9,3,0,0,0,0,51
1108439,60,12,3,0,0,0,0,75
1108440,36,5,3,0,0,0,0,44
1108441,20,3,0,3,0,0,0,26
1108442,24,8,0,0,0,0,0,32
1108443,37,5,9,0,0,0,0,51
1108444,47,8,3,0,0,0,0,58
1108501,0,0,0,0,0,0,0,0
1108502,43,3,0,0,0,0,0,46
1108503,3,0,0,0,0,0,0,3
1108504,29,0,5,0,0,0,0,34
1108505,31,0,3,0,0,0,0,34
1108506,20,4,5,0,0,0,0,29
1108507,14,0,3,0,0,0,0,17
1108508,10,5,0,0,0,0,0,15
1108509,10,3,0,0,0,0,0,13
1108510,26,0,0,0,0,0,0,26
1108511,20,0,0,0,0,0,0,20
1108512,24,0,4,0,0,0,0,28
1108513,35,3,4,0,0,0,0,42
1108514,31,4,0,0,0,0,0,35
1108515,22,0,0,0,0,0,0,22
1108516,21,3,0,0,0,0,0,24
1108517,51,0,5,0,0,0,0,56
1108518,33,0,3,0,0,0,0,36
1108519,39,3,0,0,0,0,0,42
1108520,3,0,0,0,0,0,0,3
1108521,3,0,0,0,0,0,0,3
1108522,0,4,0,0,0,0,0,4
1108523,20,0,0,0,0,0,0,20
1108524,11,0,0,0,0,0,0,11
1108525,22,3,0,0,0,0,0,25
1108526,22,0,0,0,0,0,0,22
1108527,25,0,0,0,0,3,3,31
1108528,18,6,0,4,0,0,0,28
1108529,24,4,3,0,0,0,0,31
1108530,14,3,0,0,0,0,0,17
1108531,28,4,4,0,0,0,3,39
1108601,39,6,0,0,0,0,0,45
1108602,32,4,0,0,0,0,0,36
1108603,29,8,3,0,0,0,0,40
1108604,24,3,3,3,0,0,0,33
1108605,24,0,4,0,0,0,0,28
1108606,15,0,0,3,0,0,0,18
1108607,24,0,0,0,0,0,0,24
1108608,35,4,3,0,0,0,0,42
1108609,41,5,3,0,0,0,0,49
1108610,31,0,0,0,0,0,0,31
1108611,34,0,5,0,0,0,0,39
1108612,33,0,4,0,0,0,0,37
1108613,42,5,3,0,0,0,0,50
1108701,16,0,0,0,0,0,0,16
1108702,20,4,0,0,0,0,0,24
1108703,14,4,0,0,0,0,3,21
1108704,15,0,5,0,0,0,0,20
1108705,19,3,0,0,0,0,0,22
1108706,14,3,0,0,0,0,0,17
1108707,13,3,0,0,0,0,0,16
1108708,18,0,0,0,0,0,0,18
1108709,34,3,3,0,0,0,0,40
1108710,25,0,3,0,0,0,0,28
1108711,29,0,0,0,0,0,0,29
1108712,12,0,0,0,0,0,0,12
1108713,31,0,0,0,0,0,0,31
1108801,0,0,0,0,0,0,0,0
1108802,78,7,3,0,0,0,0,88
1108803,41,3,3,0,0,0,0,47
1108804,36,4,3,0,0,0,0,43
1108805,23,3,0,0,0,0,0,26
1108806,39,4,0,4,0,0,0,47
1108807,0,0,0,0,0,0,0,0
1108808,43,7,3,0,0,0,0,53
1108809,29,4,0,0,0,0,0,33
1108810,23,3,4,0,0,0,0,30
1108811,45,11,3,0,0,0,0,59
1108812,52,9,3,0,0,0,0,64
1108813,39,8,4,0,0,0,0,51
1108814,30,6,5,0,0,0,0,41
1108815,62,5,4,0,0,0,0,71
1108816,36,6,0,0,0,0,0,42
1108817,68,0,3,0,0,0,0,71
1108818,66,10,5,0,0,0,0,81
1108819,41,0,0,0,0,0,0,41
1108820,69,4,0,0,0,0,4,77
1108901,34,0,4,0,0,0,0,38
1108902,59,6,3,0,0,0,0,68
1108903,21,4,0,0,0,0,0,25
1108904,20,5,0,3,0,0,0,28
1108905,74,7,0,0,0,0,0,81
1108906,38,0,0,4,0,0,0,42
1108907,10,0,0,0,0,0,0,10
1108908,75,3,0,0,0,3,0,81
1108909,8,0,0,0,0,0,0,8
1108910,25,3,3,0,0,0,0,31
1108911,60,6,4,0,0,0,3,73
1108912,48,4,0,0,0,0,0,52
1108913,0,0,0,0,0,0,0,0
1108914,57,8,6,0,0,0,0,71
1108915,42,8,3,0,0,0,0,53
1108916,36,3,3,0,0,0,3,45
1108917,34,4,3,0,0,0,0,41
1108918,25,4,4,0,0,0,0,33
1108919,31,7,5,0,0,0,0,43
1108920,16,3,3,0,0,0,0,22
1108921,37,9,0,0,0,0,0,46
1108922,29,4,3,0,0,0,0,36
1108923,19,3,3,0,0,0,0,25
1108924,55,4,7,0,0,0,0,66
1108925,13,0,4,3,0,0,0,20
1108926,14,0,0,0,0,3,0,17
1108927,0,0,0,0,0,0,0,0
1108928,24,11,0,0,0,0,0,35
1108929,43,3,5,0,0,0,0,51
1108930,27,0,4,4,0,0,0,35
1108931,22,4,0,0,0,0,0,26
1108932,43,3,3,0,0,0,0,49
1108933,50,3,0,0,0,0,0,53
1108934,57,0,3,3,0,0,0,63
1108935,40,3,9,0,0,0,0,52
1108936,0,0,0,0,0,0,0,0
1108937,8,0,0,0,0,0,0,8
1108938,3,0,0,0,0,0,0,3
1108939,33,0,0,0,0,0,0,33
1108940,16,0,0,0,0,0,3,19
1108941,16,0,0,0,0,0,0,16
1108942,0,0,0,0,0,0,0,0
1108943,36,5,5,0,0,0,0,46
1108944,33,0,3,0,0,0,3,39
1108945,33,3,4,0,0,0,0,40
1108946,46,9,0,0,0,0,3,58
1108947,29,5,0,0,0,0,0,34
1108948,56,5,3,0,0,0,0,64
1108949,32,3,0,0,0,0,3,38
1108950,49,0,0,4,0,0,0,53
1108951,45,0,4,0,0,0,0,49
1108952,10,0,0,0,0,0,0,10
1108953,0,0,0,0,0,0,0,0
1108954,39,3,3,3,0,0,0,48
1108955,40,3,3,0,0,0,0,46
1108956,20,4,3,0,0,0,3,30
1109001,14,0,3,0,0,0,0,17
1109002,0,0,0,0,0,0,0,0
1109003,26,3,3,0,0,0,0,32
1109004,27,0,0,3,0,0,0,30
1109005,13,0,4,0,0,0,0,17
1109006,18,4,5,0,0,0,0,27
1109007,19,4,0,0,0,0,0,23
1109008,12,4,0,0,0,0,0,16
1109009,34,3,3,0,0,0,4,44
1109010,26,0,0,0,0,0,0,26
1109011,24,4,4,0,0,0,0,32
1109012,31,0,0,0,0,0,0,31
1109013,19,4,0,0,0,0,0,23
1109014,20,4,0,0,0,0,0,24
1109015,43,3,3,0,0,0,0,49
1109101,58,4,5,0,0,0,0,67
1109102,35,3,3,3,0,0,0,44
1109103,31,3,0,0,0,0,4,38
1109104,50,9,3,0,0,0,3,65
1109105,41,8,3,0,0,0,0,52
1109106,31,4,0,0,0,0,0,35
1109107,40,4,5,0,0,0,0,49
1109108,37,3,4,0,0,0,3,47
1109109,41,0,3,0,0,0,0,44
1109110,38,3,3,0,0,0,0,44
1109111,40,5,3,0,0,0,3,51
1109112,56,5,3,3,0,0,3,70
1109113,27,0,5,0,0,0,0,32
1109114,7,0,0,0,0,0,0,7
1109115,23,0,0,0,0,0,0,23
1109116,42,0,0,0,0,0,0,42
1109117,0,0,0,0,0,0,0,0
1109118,13,0,5,0,0,0,0,18
1109119,93,6,4,0,0,0,0,103
1109120,29,0,3,0,0,0,0,32
1109121,23,3,3,0,0,0,0,29
1109122,7,3,5,3,0,0,0,18
1109123,40,4,0,3,0,0,0,47
1109124,58,5,3,0,0,0,0,66
1109125,26,0,3,0,0,0,0,29
1109126,30,0,3,0,0,0,0,33
1109127,38,5,3,0,0,0,0,46
1109128,28,3,0,0,0,0,0,31
1109201,41,5,4,0,0,0,0,50
1109202,35,3,3,0,3,0,0,44
1109203,17,0,3,0,0,0,0,20
1109204,48,0,3,0,0,0,0,51
1109205,25,0,0,0,0,0,0,25
1109206,4,0,0,0,0,0,4,8
1109207,26,4,0,5,0,0,0,35
1109208,23,3,0,0,0,0,6,32
1109209,24,0,0,0,0,0,0,24
1109210,14,0,3,3,0,0,3,23
1109211,24,0,0,0,0,0,3,27
1109212,22,0,0,4,0,0,3,29
1109213,18,0,4,0,0,0,0,22
1109301,7,0,0,0,0,0,0,7
1109302,41,4,5,3,0,0,3,56
1109303,24,7,4,0,0,0,0,35
1109304,41,4,5,0,0,0,0,50
1109305,21,3,7,0,0,0,0,31
1109306,11,0,3,0,0,0,0,14
1109307,39,0,3,0,0,0,0,42
1109308,22,0,5,0,0,0,0,27
1109309,41,3,4,0,0,0,0,48
1109310,40,4,3,3,0,0,0,50
1109311,26,0,3,0,0,0,0,29
1109312,13,0,0,0,0,0,0,13
1109313,32,3,3,0,0,0,0,38
1109314,51,4,0,0,0,0,0,55
1109401,26,0,0,0,0,0,0,26
1109402,7,0,0,0,0,0,0,7
1109403,20,3,0,0,0,0,0,23
1109404,23,3,0,3,0,0,0,29
1109405,16,3,0,0,0,0,0,19
1109406,46,0,0,0,0,0,0,46
1109407,27,0,3,0,0,0,3,33
1109408,35,3,0,0,0,0,0,38
1109409,22,0,0,0,0,0,0,22
1109410,27,0,3,0,0,0,0,30
1109411,22,0,3,3,0,0,0,28
1109412,24,0,3,3,0,0,0,30
1109413,19,0,3,0,0,0,0,22
1109414,23,3,0,3,0,0,4,33
1109501,25,4,0,0,0,0,0,29
1109502,25,0,5,0,0,0,0,30
1109503,54,8,6,0,0,0,0,68
1109504,37,0,0,0,0,0,0,37
1109505,73,0,0,0,0,0,0,73
1109506,21,0,0,0,0,0,0,21
1109507,34,0,4,0,0,0,0,38
1109508,45,3,4,0,0,3,0,55
1109509,22,3,3,3,0,0,0,31
1109510,31,0,0,0,0,0,0,31
1109511,25,5,5,4,0,0,0,39
1109512,21,0,3,0,0,0,0,24
1109513,40,6,0,3,0,0,0,49
1109514,18,0,0,0,3,0,0,21
1109515,0,0,0,0,0,0,0,0
1109601,20,5,0,0,0,0,0,25
1109602,35,3,0,3,0,0,0,41
1109603,8,0,0,0,0,0,3,11
1109604,17,0,3,0,0,0,0,20
1109605,14,0,0,0,0,0,0,14
1109606,10,0,6,3,0,3,0,22
1109607,12,0,0,3,0,0,0,15
1109608,3,0,0,3,0,0,0,6
1109609,7,0,0,3,0,0,0,10
1109610,29,0,6,0,0,0,0,35
1109611,15,3,3,0,0,3,0,24
1109612,23,0,0,0,0,0,0,23
1109613,14,0,0,0,0,0,0,14
1109614,31,3,0,0,0,0,0,34
1109615,52,4,0,0,0,0,0,56
1109616,13,0,0,0,0,0,0,13
1109617,9,0,3,3,0,0,0,15
1109618,20,0,3,0,0,0,0,23
1109619,7,4,0,0,0,0,0,11
1109620,18,3,3,0,0,0,3,27
1109621,14,3,3,3,0,0,0,23
1109622,26,5,3,0,0,0,3,37
1109623,25,5,3,3,0,0,0,36
1109624,23,3,3,3,0,0,0,32
1109701,17,4,0,0,0,0,0,21
1109702,24,0,3,0,0,0,0,27
1109703,20,0,3,0,0,0,0,23
1109704,8,3,0,0,0,0,0,11
1109705,17,4,3,3,0,0,0,27
1109706,20,4,0,0,0,0,0,24
1109707,21,0,0,0,0,0,0,21
1109708,13,3,3,0,0,0,0,19
1109709,25,0,3,0,0,0,0,28
1109710,7,0,0,0,0,0,0,7
1109711,18,0,0,0,0,0,0,18
1109712,28,3,0,0,0,0,0,31
1109713,42,5,4,0,0,0,0,51
1109714,32,3,4,0,0,0,0,39
1109715,32,5,0,3,0,0,0,40
1109716,15,0,3,0,0,0,0,18
1109717,37,4,0,0,0,0,0,41
1109718,26,3,0,0,0,0,0,29
1109719,50,7,3,0,0,0,0,60
1109720,32,6,0,0,0,0,0,38
1109721,16,0,6,3,0,0,0,25
1109722,20,5,3,0,0,0,0,28
1109723,40,0,3,0,0,0,0,43
1109724,49,4,0,0,0,0,0,53
1109725,36,5,4,0,0,0,0,45
1109726,19,3,0,0,0,0,4,26
1109727,14,0,0,0,0,0,4,18
1109728,38,7,3,0,0,0,0,48
1109729,19,6,0,0,0,0,0,25
1109730,52,3,3,0,0,0,0,58
1109731,16,3,0,0,0,0,0,19
1109732,12,3,0,0,0,0,3,18
1109733,22,3,0,0,0,0,3,28
1109734,34,5,0,0,0,0,0,39
1109735,14,4,3,0,0,0,0,21
1109736,20,3,0,0,0,0,0,23
1109737,34,0,4,0,0,0,0,38
1109738,31,3,3,0,0,0,3,40
1109739,23,3,3,0,0,0,0,29
1109740,31,3,3,0,0,0,3,40
1109741,15,4,3,0,0,0,0,22
1109742,31,0,3,0,0,0,4,38
1109743,23,0,3,0,0,0,0,26
1109744,19,5,6,0,0,0,0,30
1109745,31,3,3,0,0,0,0,37
1109746,33,0,3,0,0,0,0,36
1109747,37,6,0,0,0,0,0,43
1109748,27,7,3,0,0,0,0,37
1109749,29,3,3,0,0,0,0,35
1109750,37,0,4,0,0,0,0,41
1109751,28,3,7,4,0,0,0,42
1109752,11,0,0,0,0,0,0,11
1109801,4,0,0,0,0,0,0,4
1109802,21,4,0,0,0,0,0,25
1109803,27,0,0,0,0,0,0,27
1109804,34,0,0,0,0,0,0,34
1109805,26,0,0,0,0,0,0,26
1109806,24,0,0,0,0,0,0,24
1109807,39,0,0,0,0,0,0,39
1109808,6,3,3,3,0,0,0,15
1109809,9,0,0,0,0,0,0,9
1109810,9,4,0,0,0,0,0,13
1109811,16,3,3,0,0,3,3,28
1109901,27,0,3,0,0,0,0,30
1109902,30,7,0,0,0,0,3,40
1109903,34,0,7,0,0,0,0,41
1109904,25,0,0,0,0,0,0,25
1109905,18,0,3,0,0,0,0,21
1109906,16,3,3,0,0,0,0,22
1109907,14,0,0,0,0,0,0,14
1109908,28,0,0,0,0,0,0,28
1109909,11,0,0,0,0,0,3,14
1109910,19,4,0,0,0,0,0,23
1109911,17,3,0,0,0,0,0,20
1109912,19,0,3,0,0,0,0,22
1109913,23,0,3,0,0,0,0,26
1109914,17,0,3,0,0,0,3,23
1109915,25,0,0,0,0,0,0,25
1109916,69,4,0,0,0,0,3,76
1109917,18,0,0,0,0,0,0,18
1109918,8,0,3,3,0,0,0,14
1109919,28,0,3,0,3,3,0,37
1109920,41,3,0,0,0,0,0,44
1109921,29,3,0,0,0,0,0,32
1109922,17,0,0,0,0,0,0,17
1109923,23,0,0,0,0,0,0,23
1109924,29,0,0,3,0,0,0,32
1109925,31,3,3,0,0,0,0,37
1109926,11,0,3,0,0,0,0,14
1109927,7,0,3,0,0,0,0,10
1109928,21,3,3,0,0,0,0,27
1109929,13,0,0,0,0,0,0,13
1110001,48,8,0,0,0,0,0,56
1110002,24,3,3,3,0,0,0,33
1110003,30,4,0,0,0,0,0,34
1110004,45,7,6,0,0,0,0,58
1110005,63,0,0,4,0,0,0,67
1110006,57,5,5,4,0,0,0,71
1110007,45,0,0,0,0,0,0,45
1110008,19,4,3,0,0,0,0,26
1110009,24,0,4,4,0,0,0,32
1110010,3,3,0,4,0,0,0,10
1110011,15,0,3,3,0,0,0,21
1110012,26,3,3,0,0,0,0,32
1110013,19,3,3,0,0,0,0,25
1110014,21,3,0,0,0,0,0,24
1110015,40,7,0,0,0,0,0,47
1110016,40,3,0,0,0,0,3,46
1110017,98,3,0,0,0,0,0,101
1110018,43,0,0,0,0,0,0,43
1110019,19,5,6,0,0,0,0,30
1110020,62,6,3,0,0,0,0,71
1110021,20,0,0,0,0,0,0,20
1110022,44,5,7,3,0,3,3,65
1110023,25,3,5,0,0,0,0,33
1110024,28,4,3,0,0,0,0,35
1110025,33,3,4,0,0,0,0,40
1110026,55,0,7,3,0,0,0,65
1110027,71,0,0,0,0,0,0,71
1110101,13,0,0,0,3,0,0,16
1110102,44,6,3,0,0,0,4,57
1110103,60,3,0,0,0,0,3,66
1110104,40,4,0,4,0,0,0,48
1110105,94,9,3,0,0,0,4,110
1110106,33,0,0,0,0,0,0,33
1110107,47,4,0,3,0,0,0,54
1110108,27,3,0,0,0,0,0,30
1110109,41,3,3,0,0,0,0,47
1110110,19,3,3,0,0,0,0,25
1110111,23,0,3,0,0,0,0,26
1110112,36,3,3,0,0,0,0,42
1110113,34,4,4,0,0,0,0,42
1110114,33,5,0,5,0,0,0,43
1110115,42,4,4,0,0,0,0,50
1110116,26,5,0,0,0,0,0,31
1110117,34,0,3,0,0,0,0,37
1110118,42,3,3,0,0,0,0,48
1110119,46,0,3,0,0,0,0,49
1110120,41,3,4,0,0,0,0,48
1110121,63,4,8,3,0,0,0,78
1110122,13,0,3,0,0,0,0,16
1110123,40,3,8,0,0,0,0,51
1110124,40,0,3,0,0,0,0,43
1110125,29,3,3,3,0,0,0,38
1110126,26,4,5,0,0,0,0,35
1110127,41,5,3,0,0,0,0,49
1110128,37,4,6,0,0,0,3,50
1110129,45,3,10,3,0,0,0,61
1110130,30,3,3,0,0,0,3,39
1110131,110,7,5,0,0,0,0,122
1110132,46,0,4,0,0,0,0,50
1110133,28,6,0,0,0,0,0,34
1110134,59,3,0,0,0,0,3,65
1110135,17,4,0,0,0,0,0,21
1110136,22,0,3,0,0,0,0,25
1110137,6,0,0,0,0,0,0,6
1110201,33,9,3,0,0,0,0,45
1110202,24,0,0,0,0,0,0,24
1110203,14,0,5,0,0,0,0,19
1110204,24,3,3,3,0,0,3,36
1110205,44,9,4,0,0,0,0,57
1110206,26,4,7,0,0,0,0,37
1110207,30,3,0,3,0,0,0,36
1110208,21,4,4,4,0,0,0,33
1110209,16,3,3,0,0,0,0,22
1110210,12,3,7,0,0,0,0,22
1110211,27,3,3,0,0,0,0,33
1110212,73,9,3,0,0,0,3,88
1110213,47,7,0,3,0,0,0,57
1110214,27,4,4,0,0,0,0,35
1110215,101,5,5,0,0,0,0,111
1110216,104,6,6,0,0,0,0,116
1110217,21,4,0,0,0,0,0,25
1110218,5,0,0,0,0,0,0,5
1110301,28,3,0,5,0,0,0,36
1110302,28,3,0,0,0,0,0,31
1110303,40,3,0,3,0,0,0,46
1110304,51,3,0,0,0,0,0,54
1110305,24,5,0,0,0,0,0,29
1110306,45,3,3,0,0,0,0,51
1110307,51,0,0,0,0,0,0,51
1110308,13,0,0,0,0,0,0,13
1110309,26,3,4,0,0,0,0,33
1110310,32,0,3,0,0,0,3,38
1110311,47,7,3,3,0,0,3,63
1110312,23,3,3,0,0,0,0,29
1110313,22,3,0,0,0,0,0,25
1110314,19,0,3,3,0,0,0,25
1110315,20,3,0,0,0,0,0,23
1110316,36,3,3,0,0,0,3,45
1110317,52,8,3,0,0,0,0,63
1110318,15,0,3,0,0,0,0,18
1110401,31,4,3,0,0,0,0,38
1110402,46,5,4,0,0,0,0,55
1110403,24,0,0,0,0,0,4,28
1110404,15,0,0,0,0,0,0,15
1110405,36,0,0,0,0,0,0,36
1110406,40,0,0,0,0,0,0,40
1110407,30,4,0,0,0,0,0,34
1110408,12,0,0,0,0,0,0,12
1110409,22,3,3,0,0,0,3,31
1110410,13,3,3,3,0,0,3,25
1110411,19,3,3,0,0,0,0,25
1110412,21,6,0,0,0,0,0,27
1110413,18,4,4,0,0,0,0,26
1110414,0,0,0,0,0,0,0,0
1110415,8,0,0,0,0,0,0,8
1110416,36,3,0,0,0,0,0,39
1110501,28,0,0,0,0,0,5,33
1110502,45,0,0,0,0,0,3,48
1110503,14,0,3,0,0,0,0,17
1110504,27,4,3,0,0,0,4,38
1110505,54,5,0,0,0,0,4,63
1110506,27,0,0,0,0,0,0,27
1110507,23,3,0,0,0,0,3,29
1110508,28,0,3,0,0,0,0,31
1110509,45,5,6,0,0,0,0,56
1110510,16,0,0,0,0,0,0,16
1110511,10,3,3,0,0,0,0,16
1110512,35,0,4,0,0,0,0,39
1110513,39,3,3,0,0,0,0,45
1110514,14,3,0,0,0,0,0,17
1110515,76,0,3,0,0,0,3,82
1110516,35,0,3,0,0,0,0,38
1110517,53,0,3,3,0,0,0,59
1110518,21,0,0,0,3,0,0,24
1110601,4,0,0,0,0,0,0,4
1110602,10,0,0,0,0,0,0,10
1110603,5,0,0,0,0,0,0,5
1110604,18,0,0,0,0,0,0,18
1110605,15,6,3,0,3,0,5,32
1110606,34,0,0,0,0,0,0,34
1110607,26,3,5,3,0,0,0,37
1110608,13,4,0,0,0,0,0,17
1110609,50,0,5,0,0,0,0,55
1110610,14,3,4,3,0,0,3,27
1110611,47,3,3,0,0,0,0,53
1110612,18,3,0,3,0,0,0,24
1110613,10,0,0,0,0,0,0,10
1110614,56,4,0,0,0,0,0,60
1110615,56,0,3,0,0,0,0,59
1110616,41,3,3,0,0,0,3,50
1110617,40,3,6,0,0,0,3,52
1110618,53,0,3,3,0,0,0,59
1110619,36,0,0,0,0,0,0,36
1110620,17,3,0,0,0,0,0,20
1110621,24,3,3,0,0,0,0,30
1110622,19,0,0,0,0,0,0,19
1110623,34,0,4,0,0,0,0,38
1110624,28,6,3,0,0,0,3,40
1110701,60,3,4,0,0,0,0,67
1110702,57,7,5,0,0,0,0,69
1110703,41,5,3,0,0,0,3,52
1110704,45,4,4,0,0,0,0,53
1110705,31,0,3,0,0,0,0,34
1110706,30,3,3,0,0,0,0,36
1110707,25,3,3,0,0,0,0,31
1110708,33,6,3,0,0,0,0,42
1110709,28,4,3,0,0,0,0,35
1110710,33,3,5,0,0,0,0,41
1110711,44,0,0,0,0,0,0,44
1110712,43,4,4,3,0,0,0,54
1110713,27,3,4,0,0,0,4,38
1110714,58,7,3,0,0,0,0,68
1110715,48,4,0,0,0,0,0,52
1110716,96,4,0,0,0,0,0,100
1110717,22,5,0,0,0,0,0,27
1110718,29,3,4,0,0,0,0,36
1110719,19,3,3,0,0,0,0,25
1110720,53,5,3,0,0,0,0,61
1110721,115,6,8,0,0,0,0,129
1110722,43,5,0,0,0,0,0,48
1110723,66,5,3,3,0,0,3,80
1110801,33,3,4,0,0,0,0,40
1110802,114,3,3,3,0,0,0,123
1110803,16,0,3,0,0,0,0,19
1110804,0,0,0,0,0,0,0,0
1110805,80,5,4,0,0,0,0,89
1110806,20,5,0,0,0,0,0,25
1110807,31,3,10,3,0,0,0,47
1110808,36,4,4,0,0,0,0,44
1110809,25,4,0,0,0,0,0,29
1110810,40,0,5,0,0,0,0,45
1110811,35,6,3,0,0,0,0,44
1110812,24,3,3,3,0,0,3,36
1110813,21,5,4,0,0,0,0,30
1110814,14,0,0,0,0,0,0,14
1110815,22,3,3,0,0,0,0,28
1110816,42,0,0,4,0,0,0,46
1110817,46,7,6,0,0,0,0,59
1110818,3,3,0,0,0,0,0,6
1110819,30,4,4,0,0,0,3,41
1110820,41,0,5,3,0,0,0,49
1110821,27,9,6,0,0,0,0,42
1110822,62,7,3,0,0,0,3,75
1110823,17,3,3,0,0,0,0,23
1110824,16,0,3,0,0,0,0,19
1110825,29,7,0,0,0,0,0,36
1110826,23,3,0,0,0,0,0,26
1110827,6,4,0,0,0,0,0,10
1110828,0,0,0,0,0,0,0,0
1110829,30,9,3,3,0,0,0,45
1110830,53,9,6,0,0,0,0,68
1110831,22,0,0,0,0,0,3,25
1110832,20,3,3,0,0,0,0,26
1110833,25,0,5,0,0,0,0,30
1110834,29,0,3,0,0,0,3,35
1110835,15,0,4,0,0,0,0,19
1110836,63,7,6,3,0,0,0,79
1110837,36,9,7,0,0,0,0,52
1110838,22,5,4,0,0,0,0,31
1110839,33,3,0,0,0,0,0,36
1110840,29,0,4,0,0,0,0,33
1110841,37,4,4,0,0,0,0,45
1110842,41,6,3,0,0,0,0,50
1110843,29,5,4,0,0,0,0,38
1110844,30,3,3,3,0,0,0,39
1110845,23,4,0,0,0,0,0,27
1110846,30,4,3,0,0,0,0,37
1110847,75,3,8,0,3,0,3,92
1110848,22,3,0,0,0,0,0,25
1110849,31,7,4,0,3,0,0,45
1110850,44,6,3,0,0,0,0,53
1110851,37,3,0,0,0,3,0,43
1110852,28,3,0,0,0,0,0,31
1110853,40,3,10,0,0,0,0,53
1110901,39,3,4,0,0,0,0,46
1110902,18,3,4,0,0,0,0,25
1110903,27,4,3,0,0,0,3,37
1110904,22,0,0,5,0,0,0,27
1110905,40,5,0,0,0,0,0,45
1110906,47,0,3,0,0,0,0,50
1110907,23,0,0,0,0,0,0,23
1110908,40,0,3,3,0,0,3,49
1110909,31,10,3,0,0,0,0,44
1110910,48,3,6,0,0,0,0,57
1110911,26,3,0,0,0,0,0,29
1110912,36,4,5,0,0,3,0,48
1110913,32,0,3,4,0,0,3,42
1110914,46,3,0,0,0,0,0,49
1110915,29,3,0,0,0,0,0,32
1110916,57,3,7,0,0,0,0,67
1110917,24,4,0,0,0,0,0,28
1110918,24,0,0,0,0,0,0,24
1110919,21,5,0,0,0,0,0,26
1110920,31,3,0,0,0,0,0,34
1110921,5,0,4,0,0,0,0,9
1110922,31,3,0,3,0,0,0,37
1110923,23,5,0,0,0,0,0,28
1111001,21,3,0,0,0,0,0,24
1111002,56,0,8,3,0,0,0,67
1111003,32,0,4,3,0,0,0,39
1111004,14,0,0,0,0,0,0,14
1111005,27,4,0,0,0,0,0,31
1111006,28,4,0,0,0,0,0,32
1111007,43,3,3,0,0,0,0,49
1111008,24,0,0,0,0,0,0,24
1111009,35,3,0,0,0,0,0,38
1111010,24,0,3,0,0,0,0,27
1111011,55,0,0,0,0,0,0,55
1111012,33,3,3,0,0,0,0,39
1111013,17,4,0,3,0,0,0,24
1111014,30,3,0,0,0,0,0,33
1111015,21,0,4,0,0,0,0,25
1111016,23,3,4,0,0,0,0,30
1111017,28,3,0,3,0,0,0,34
1111018,22,3,0,3,0,0,0,28
1111019,31,3,3,0,0,0,0,37
1111020,35,4,3,0,0,0,0,42
1111021,33,3,3,0,0,0,3,42
1111022,28,4,4,0,0,0,0,36
1111023,36,6,5,3,0,0,0,50
1111024,46,3,0,0,0,0,0,49
1111025,21,3,0,0,0,0,0,24
1111026,26,4,0,0,0,0,0,30
1111027,60,0,5,0,0,0,0,65
1111101,41,13,6,0,0,0,0,60
1111102,23,9,4,0,0,0,0,36
1111103,11,4,0,0,0,0,0,15
1111104,10,3,3,0,0,0,0,16
1111105,19,11,4,0,0,0,0,34
1111106,28,7,0,3,0,0,0,38
1111107,16,0,0,0,0,0,0,16
1111108,40,5,0,0,0,0,0,45
1111109,26,4,3,0,0,0,0,33
1111110,29,5,3,0,0,0,0,37
1111111,51,4,4,0,0,0,0,59
1111112,36,5,3,0,0,0,3,47
1111113,46,11,4,0,0,0,0,61
1111114,30,7,3,0,0,0,0,40
1111115,57,3,3,3,0,0,0,66
1111116,39,4,8,0,0,0,0,51
1111117,38,4,3,0,0,0,0,45
1111118,41,0,3,0,0,0,0,44
1111119,66,4,3,0,0,0,0,73
1111120,71,4,3,0,0,0,0,78
1111121,33,0,4,0,0,0,0,37
1111122,34,3,3,0,0,0,0,40
1111123,42,5,0,0,0,0,0,47
1111124,42,4,6,0,0,0,3,55
1111125,31,3,3,0,0,0,0,37
1111126,53,5,6,0,0,0,0,64
1111127,41,3,0,0,0,0,0,44
1111128,27,3,9,0,0,0,4,43
1111129,32,3,3,0,0,0,3,41
1111130,58,4,6,0,0,0,0,68
1111131,32,0,0,0,0,0,3,35
1111132,22,4,0,4,0,0,3,33
1111133,35,3,3,0,0,0,0,41
1111134,33,3,3,0,0,3,0,42
1111135,36,3,3,0,0,0,0,42
1111136,25,4,5,0,0,4,0,38
1111137,0,0,0,0,0,0,0,0
1111138,30,5,3,0,0,0,0,38
1111139,0,0,0,0,0,0,0,0
1111140,32,0,3,0,0,3,0,38
1111141,30,5,0,0,0,0,3,38
1111142,0,0,0,0,0,0,0,0
1111143,22,0,3,0,0,0,0,25
1111144,15,3,0,0,0,0,0,18
1111145,21,3,0,0,0,0,3,27
1111146,0,0,0,0,0,0,0,0
1111147,54,6,3,0,0,0,0,63
1111201,46,4,3,3,0,0,0,56
1111202,46,4,4,0,0,0,0,54
1111203,60,0,0,0,0,0,0,60
1111204,37,7,0,0,0,0,0,44
1111205,25,3,0,0,0,0,3,31
1111206,26,4,3,0,0,0,3,36
1111207,30,4,3,4,0,0,0,41
1111208,17,0,0,0,0,0,0,17
1111209,46,3,3,0,0,0,0,52
1111210,44,3,4,0,0,0,0,51
1111211,21,4,0,0,0,0,0,25
1111212,53,0,4,0,0,0,0,57
1111213,32,3,3,0,0,0,0,38
1111214,47,5,5,0,0,0,0,57
1111215,26,0,0,0,0,0,0,26
1111216,29,5,4,0,0,0,0,38
1111217,52,3,0,0,0,0,0,55
1111218,28,0,0,0,0,0,0,28
1111219,43,7,3,0,0,0,3,56
1111220,14,0,0,0,0,0,0,14
1111221,32,3,3,0,0,0,0,38
1111222,22,3,3,3,0,0,0,31
1111223,25,5,0,0,0,0,0,30
1111224,66,3,3,0,0,0,0,72
1111225,38,3,3,3,0,0,0,47
1111226,55,3,0,0,0,0,0,58
1111227,51,5,3,0,0,0,0,59
1111228,24,3,3,0,0,0,0,30
1111229,32,4,0,0,0,0,0,36
1111230,34,9,0,0,0,0,0,43
1111231,48,4,6,5,0,0,0,63
1111232,31,0,4,0,0,0,0,35
1111233,48,7,3,0,0,0,3,61
1111234,34,0,5,0,0,0,0,39
1111235,54,6,7,0,0,0,0,67
1111236,98,5,4,0,0,0,0,107
1111237,42,4,4,0,0,0,0,50
1111238,35,4,3,0,0,0,0,42
1111239,80,9,3,0,0,0,0,92
1111240,19,0,3,0,0,0,0,22
1111241,11,4,0,0,0,0,0,15
1111242,47,0,6,0,0,0,0,53
1111243,118,12,3,0,0,0,0,133
1111301,26,5,5,0,0,0,0,36
1111302,39,8,0,0,0,0,0,47
1111303,24,4,0,0,0,0,0,28
1111304,24,3,3,0,0,0,3,33
1111305,38,3,6,0,0,0,0,47
1111306,44,5,0,0,0,0,0,49
1111307,23,0,0,0,0,0,0,23
1111308,16,3,3,0,0,0,0,22
1111309,56,5,4,0,0,0,0,65
1111310,30,3,0,0,0,0,0,33
1111311,53,3,0,3,0,0,0,59
1111312,65,3,0,0,0,0,3,71
1111313,43,4,3,0,0,0,0,50
1111314,63,3,3,0,0,0,0,69
1111315,36,4,4,0,0,0,0,44
1111401,21,5,0,0,0,0,0,26
1111402,39,6,3,0,0,0,0,48
1111403,12,3,5,0,0,0,0,20
1111404,94,3,0,0,0,0,0,97
1111405,41,5,3,0,0,0,0,49
1111406,20,3,0,0,0,0,0,23
1111407,69,9,4,0,0,0,0,82
1111408,35,4,0,0,0,0,0,39
1111409,18,3,0,0,0,0,0,21
1111410,42,0,3,0,0,0,0,45
1111411,21,3,0,0,0,0,0,24
1111412,26,3,3,0,0,0,0,32
1111501,58,3,3,0,0,0,3,67
1111502,25,0,7,0,0,0,0,32
1111503,25,3,3,0,0,0,0,31
1111504,19,3,0,0,0,0,3,25
1111505,31,4,4,3,0,0,0,42
1111506,29,4,0,0,0,0,0,33
1111507,29,0,4,0,0,0,0,33
1111508,49,3,3,0,0,0,0,55
1111509,55,7,3,0,0,0,0,65
1111510,29,5,0,0,0,0,0,34
1111511,45,0,7,0,0,0,0,52
1111512,48,0,6,0,0,0,0,54
1111513,18,4,4,0,0,0,0,26
1111514,61,7,5,0,0,0,0,73
1111515,49,7,0,0,0,0,0,56
1111516,52,4,4,0,0,0,0,60
1111517,57,10,0,0,0,0,0,67
1111518,26,0,0,0,0,0,3,29
1111519,37,3,3,0,0,0,0,43
1111520,50,9,8,0,0,0,0,67
1111521,16,0,5,0,0,0,0,21
1111522,87,4,12,3,0,0,0,106
1111523,61,0,0,6,0,0,0,67
1111524,44,7,3,0,0,0,0,54
1111525,11,6,3,0,0,0,0,20
1111526,76,7,6,0,0,0,0,89
1111527,46,3,4,0,0,0,0,53
1111528,31,6,3,0,0,0,0,40
1111529,51,5,0,4,0,0,0,60
1111530,35,9,4,0,0,0,0,48
1111531,22,3,0,0,0,4,0,29
1111532,15,0,0,0,3,0,3,21
1111533,54,6,3,0,0,0,0,63
1111534,25,5,0,0,0,0,0,30
1111535,42,0,3,4,0,0,0,49
1111536,14,0,0,0,0,0,0,14
1111537,29,0,3,0,0,0,0,32
1111538,57,11,8,0,0,0,0,76
1111539,55,8,3,0,0,0,0,66
1111540,39,8,9,0,0,3,0,59
1111541,58,3,3,0,0,0,0,64
1111542,31,0,3,0,0,0,0,34
1111543,51,9,3,0,0,0,0,63
1111544,32,8,0,0,0,0,0,40
1111545,25,0,3,0,0,0,0,28
1111546,39,8,7,0,0,0,0,54
1111547,42,5,0,0,0,0,4,51
1111548,40,4,3,0,0,0,0,47
1111549,27,0,3,0,0,0,0,30
1111550,37,9,0,0,0,0,0,46
1111551,32,3,4,0,0,0,0,39
1111552,44,8,0,5,0,0,0,57
1111553,65,4,0,0,0,0,0,69
1111554,56,3,3,0,0,0,0,62
1111555,77,4,8,0,0,0,0,89
1111556,82,4,9,0,0,0,0,95
1111557,52,3,3,0,0,0,0,58
1111558,56,0,4,0,0,0,0,60
1111559,40,8,3,0,0,0,0,51
1111560,33,0,3,0,0,0,0,36
1111561,43,4,3,0,0,0,0,50
1111562,0,0,0,0,0,0,0,0
1111563,10,3,3,0,0,0,3,19
1111564,8,0,0,0,0,0,0,8
1111565,60,5,4,0,0,0,0,69
1111601,60,5,4,0,0,0,0,69
1111602,62,3,3,3,0,0,0,71
1111603,39,0,3,0,0,0,0,42
1111604,80,4,6,0,0,0,0,90
1111605,53,3,3,0,0,0,0,59
1111606,119,7,4,0,0,0,0,130
1111607,18,0,0,0,0,0,0,18
1111608,32,3,5,0,0,3,0,43
1111609,29,3,0,0,0,0,0,32
1111610,49,0,4,0,0,0,0,53
1111611,28,0,0,0,0,0,0,28
1111612,86,12,4,0,0,0,0,102
1111613,33,5,3,4,0,0,0,45
1111614,52,6,0,0,0,0,0,58
1111615,51,3,3,0,0,0,0,57
1111616,39,3,0,0,0,0,0,42
1111701,13,3,3,0,0,0,0,19
1111702,41,0,3,0,0,0,3,47
1111703,81,6,3,0,0,0,0,90
1111704,65,5,6,0,0,0,0,76
1111705,61,3,4,3,0,0,0,71
1111706,29,3,3,0,0,0,0,35
1111707,21,4,0,0,0,0,0,25
1111708,55,3,3,0,0,0,0,61
1111709,24,3,0,0,0,0,0,27
1111710,40,4,0,0,0,0,0,44
1111711,45,7,0,6,0,0,0,58
1111712,93,8,6,3,0,0,0,110
1111713,81,4,3,0,0,0,0,88
1111714,71,12,8,0,0,0,0,91
1111715,28,13,0,0,0,0,3,44
1111716,72,5,0,0,0,0,0,77
1111717,63,8,3,0,0,0,0,74
1111718,65,4,8,0,0,0,0,77
1111719,47,4,6,0,0,0,0,57
1111720,29,3,4,0,0,0,0,36
1111721,17,4,4,0,0,0,0,25
1111722,45,7,3,0,0,0,0,55
1111723,52,9,6,0,0,3,0,70
1111724,50,3,3,0,0,0,0,56
1111725,31,5,0,0,0,0,0,36
1111726,30,8,0,0,0,0,0,38
1111727,22,3,6,0,0,0,0,31
1111728,26,0,4,0,0,0,0,30
1111729,71,9,3,5,0,0,0,88
1111730,22,0,0,0,0,0,0,22
1111731,46,6,4,0,0,0,0,56
1111732,100,6,3,0,0,0,0,109
1111733,43,3,4,0,0,0,0,50
1111734,26,0,7,0,0,0,4,37
1111735,31,0,5,0,0,0,0,36
1111736,40,4,6,0,0,0,3,53
1111737,47,0,0,0,0,0,0,47
1111738,46,4,4,0,0,0,0,54
1111739,68,4,5,0,0,0,0,77
1111740,37,3,3,0,0,0,0,43
1111741,36,10,6,0,0,0,3,55
1111742,40,3,4,0,0,0,0,47
1111743,22,4,3,0,0,0,0,29
1111744,3,0,0,0,0,0,0,3
1111801,70,8,6,3,0,0,0,87
1111802,41,3,0,0,0,0,4,48
1111803,50,3,0,0,0,0,3,56
1111804,85,5,6,0,0,0,0,96
1111805,58,5,10,0,0,0,0,73
1111806,81,7,3,0,0,0,0,91
1111807,69,6,0,0,0,0,0,75
1111808,58,7,3,3,0,0,0,71
1111809,50,4,3,0,0,0,0,57
1111810,64,3,5,0,3,0,0,75
1111811,45,8,0,0,0,0,0,53
1111812,73,3,7,0,0,0,0,83
1111813,40,3,0,0,0,0,0,43
1111814,21,5,0,0,0,0,0,26
1111815,0,0,0,0,0,0,0,0
1111816,90,5,7,0,0,0,0,102
1111817,36,7,3,0,0,0,0,46
1111818,40,8,0,0,0,0,0,48
1111819,53,3,8,0,0,0,0,64
1111820,27,3,0,0,0,0,0,30
1111821,37,4,0,0,0,0,4,45
1111822,75,7,7,0,0,0,0,89
1111901,24,4,0,3,0,0,0,31
1111902,40,3,6,4,0,0,0,53
1111903,51,4,3,0,0,0,0,58
1111904,46,3,5,0,0,0,0,54
1111905,35,7,3,0,0,0,3,48
1111906,32,0,0,0,0,0,0,32
1111907,9,3,0,0,0,0,0,12
1111908,0,0,0,0,0,0,0,0
1111909,3,0,0,0,0,0,0,3
1111910,24,0,5,0,0,0,0,29
1111911,18,3,0,3,0,0,3,27
1111912,19,3,3,0,0,0,0,25
1111913,53,3,4,0,0,0,0,60
1111914,37,7,3,0,0,0,0,47
1111915,46,5,0,0,0,0,0,51
1111916,38,5,4,0,0,0,0,47
1111917,0,0,0,0,0,0,0,0
1111918,43,3,3,0,0,3,0,52
1112001,0,0,0,0,0,0,3,3
1112002,20,5,0,0,0,0,0,25
1112003,23,0,0,0,0,0,0,23
1112004,32,4,3,0,0,0,0,39
1112005,0,0,0,0,0,0,0,0
1112006,51,4,4,0,0,0,4,63
1112007,21,3,5,3,0,0,0,32
1112008,36,4,4,0,0,0,0,44
1112009,60,3,5,3,0,0,0,71
1112010,58,5,0,0,0,0,0,63
1112011,20,3,0,0,0,0,0,23
1112012,21,4,3,0,0,0,0,28
1112013,33,4,0,0,0,0,0,37
1112014,43,0,3,0,0,0,0,46
1112015,17,0,0,0,3,0,0,20
1112016,53,5,5,0,0,0,0,63
1112017,0,0,0,0,0,0,0,0
1112018,37,5,0,0,0,0,4,46
1112101,39,9,3,0,0,0,0,51
1112102,22,5,3,0,0,0,0,30
1112103,29,0,0,0,0,0,0,29
1112104,22,8,0,0,0,0,0,30
1112105,27,3,3,0,0,0,0,33
1112106,15,0,0,0,0,0,0,15
1112107,24,3,3,0,0,0,0,30
1112108,28,0,0,0,0,0,0,28
1112109,40,0,0,5,0,0,0,45
1112110,28,0,0,0,0,0,0,28
1112111,0,0,0,0,0,0,0,0
1112112,0,0,0,0,0,0,0,0
1112113,0,0,0,0,0,0,0,0
1112114,4,0,0,0,0,0,0,4
1112115,31,3,0,0,0,0,0,34
1112116,20,0,0,3,0,0,0,23
1112117,0,0,0,0,0,0,0,0
1112118,31,0,0,0,0,0,0,31
1112119,32,8,0,0,0,0,0,40
1112120,23,3,0,0,3,0,0,29
1112121,0,3,0,0,0,0,0,3
1112122,14,0,0,0,0,0,0,14
1112123,15,0,0,0,0,0,0,15
1112124,31,0,6,0,0,0,0,37
1112125,24,4,0,0,0,0,0,28
1112126,28,4,0,0,0,0,0,32
1112127,42,0,0,0,0,0,0,42
1112128,33,0,3,0,0,0,4,40
1112129,24,3,3,0,0,0,0,30
1112130,38,4,3,0,0,0,0,45
1112131,19,3,0,0,0,0,3,25
1112132,47,9,3,0,0,0,0,59
1112133,31,3,0,0,0,0,0,34
1112134,50,4,3,0,0,0,0,57
1112135,9,0,0,0,0,0,0,9
1112136,40,5,4,0,0,0,5,54
1112137,44,3,0,0,0,0,0,47
1112138,63,3,3,0,0,0,0,69
1112139,42,3,0,0,0,0,0,45
1112140,27,3,0,0,0,0,0,30
1112141,47,3,3,0,0,0,0,53
1112142,32,0,0,0,0,0,3,35
1112143,26,3,3,3,0,0,0,35
1112144,32,3,3,0,0,0,0,38
1112145,27,3,3,0,3,0,0,36
1112146,14,0,0,0,0,0,0,14
1112147,24,3,0,0,0,0,0,27
1112148,30,0,0,0,0,0,0,30
1112149,24,8,0,0,0,0,0,32
1112150,23,6,0,0,0,0,0,29
1112151,23,4,5,0,0,0,0,32
1112152,30,6,3,0,0,0,0,39
1112153,37,0,0,0,0,0,0,37
1112154,43,4,0,0,0,0,0,47
1112155,30,6,7,0,0,0,0,43
1112156,20,0,0,0,0,0,0,20
1112201,62,0,8,4,0,0,0,74
1112202,14,4,3,3,0,0,0,24
1112203,0,0,0,0,0,0,0,0
1112204,19,3,4,0,0,0,3,29
1112205,41,3,3,3,0,0,0,50
1112206,39,11,3,0,0,0,0,53
1112207,22,5,0,0,0,0,4,31
1112208,21,4,0,0,0,0,0,25
1112209,26,3,0,0,0,0,0,29
1112210,43,3,3,0,0,0,0,49
1112211,7,3,0,0,0,0,0,10
1112212,32,10,11,0,0,0,0,53
1112213,26,3,0,0,0,0,0,29
1112214,27,0,6,0,0,0,4,37
1112215,31,3,3,0,0,3,3,43
1112216,36,4,3,0,0,0,0,43
1112217,52,4,8,0,0,0,0,64
1112218,55,0,3,0,0,0,4,62
1112219,31,10,6,3,0,0,0,50
1112220,25,3,3,0,0,0,0,31
1112221,53,0,6,0,0,0,5,64
1112222,34,6,6,0,0,0,3,49
1112223,40,13,4,0,0,0,0,57
1112224,17,3,3,0,0,0,3,26
1112225,52,8,3,0,0,0,0,63
1112226,43,7,0,0,0,0,3,53
1112227,69,8,3,0,0,0,0,80
1112228,56,9,7,0,0,0,3,75
1112229,70,11,7,0,0,0,0,88
1112230,27,4,4,0,0,0,0,35
1112231,18,0,3,3,0,0,0,24
1112232,3,0,0,0,0,0,0,3
1112233,23,5,0,0,0,0,0,28
1112234,21,3,4,0,0,0,0,28
1112301,27,4,0,0,0,0,0,31
1112302,34,0,4,0,0,0,0,38
1112303,59,9,4,3,0,0,0,75
1112304,62,4,0,0,0,0,0,66
1112305,81,0,6,0,0,0,0,87
1112306,34,3,0,0,0,0,0,37
1112307,39,0,3,0,0,0,0,42
1112308,60,4,0,0,0,0,0,64
1112309,42,0,0,0,0,0,0,42
1112310,79,8,3,0,0,0,0,90
1112311,47,3,0,0,3,0,0,53
1112312,41,4,3,0,3,0,0,51
1112313,55,3,3,0,0,3,0,64
1112314,35,0,0,3,0,0,3,41
1112315,32,0,0,0,0,0,0,32
1112401,16,0,0,0,0,0,0,16
1112402,22,0,0,0,0,0,0,22
1112403,23,3,3,0,0,0,0,29
1112404,27,0,0,0,0,0,0,27
1112405,20,3,0,0,0,0,0,23
1112406,23,0,3,0,0,0,0,26
1112407,13,0,0,0,0,0,0,13
1112408,11,8,4,0,0,0,0,23
1112409,14,0,0,0,0,0,0,14
1112410,18,3,0,0,0,0,0,21
1112411,22,0,0,0,0,0,0,22
1112412,13,0,0,0,0,0,0,13
1112413,25,0,0,3,0,0,0,28
1112414,5,3,3,0,0,0,0,11
1112415,0,0,0,0,0,0,0,0
1112416,0,0,0,0,0,0,0,0
1112501,17,0,0,0,0,0,0,17
1112502,34,3,0,0,0,0,0,37
1112503,28,3,3,0,0,0,0,34
1112504,40,6,3,0,0,0,0,49
1112505,0,0,0,0,0,0,0,0
1112506,57,3,3,3,0,0,0,66
1112507,59,6,4,4,0,0,0,73
1112508,0,0,0,0,0,0,0,0
1112509,0,0,0,0,0,0,0,0
1112510,27,3,0,0,0,0,0,30
1112511,46,0,0,0,0,0,0,46
1112512,35,0,0,0,0,0,0,35
1112513,74,6,0,0,0,0,0,80
1112514,11,0,0,0,0,0,0,11
1112515,19,0,0,0,0,0,0,19
1112516,46,4,0,0,0,0,0,50
1112517,12,0,0,0,0,0,3,15
1112518,66,7,4,0,0,0,0,77
1112519,52,4,3,0,0,0,0,59
1112520,44,0,0,0,0,0,0,44
1112521,88,4,0,0,0,0,0,92
1112522,49,6,5,0,0,0,0,60
1112523,38,3,7,0,0,0,0,48
1112524,77,4,5,0,0,0,0,86
1112525,47,4,4,0,0,0,0,55
1112526,41,3,3,0,0,0,0,47
1112527,66,9,4,0,0,0,0,79
1112528,57,5,3,0,0,0,0,65
1112529,32,6,3,0,0,0,0,41
1112530,76,3,3,0,0,0,0,82
1112531,47,0,5,0,0,0,0,52
1112532,25,0,4,0,0,0,0,29
1112533,0,0,0,0,0,0,0,0
1112534,23,3,3,0,0,0,0,29
1112535,47,0,4,0,0,0,5,56
1112536,33,0,4,0,0,0,0,37
1112537,46,5,4,0,0,0,0,55
1112601,10,3,3,0,0,0,0,16
1112602,7,0,0,0,0,0,0,7
1112603,26,3,3,0,0,0,0,32
1112604,30,3,3,3,0,0,0,39
1112605,36,6,5,0,0,0,0,47
1112606,22,3,0,0,0,0,0,25
1112607,27,3,0,0,0,0,0,30
1112608,14,0,0,0,0,0,4,18
1112609,56,8,0,3,0,0,0,67
1112610,62,7,9,0,0,0,0,78
1112611,25,0,0,0,0,0,0,25
1112612,26,0,0,0,0,0,0,26
1112613,46,0,5,0,0,0,3,54
1112614,38,5,4,0,0,0,3,50
1112615,7,0,0,0,0,0,0,7
1112616,24,3,0,0,0,0,0,27
1112617,42,7,5,0,0,0,0,54
1112618,45,3,3,0,0,0,0,51
1112619,25,0,0,0,0,0,3,28
1112620,53,5,6,0,0,0,0,64
1112621,15,13,5,0,0,0,0,33
1112622,25,6,13,3,0,0,0,47
1112623,34,5,5,0,0,0,0,44
1112624,30,4,8,0,0,0,0,42
1112625,25,0,0,0,0,0,0,25
1112626,38,3,3,0,0,0,0,44
1112627,66,3,0,0,0,0,0,69
1112628,20,0,3,0,0,0,0,23
1112629,33,0,0,5,0,0,0,38
1112630,59,6,7,0,0,0,0,72
1112631,70,5,4,0,0,0,3,82
1112632,17,0,0,0,0,0,0,17
1112633,26,0,0,0,0,0,0,26
1112634,20,5,3,0,0,0,0,28
1112635,0,0,0,0,0,0,0,0
1112701,33,4,4,0,0,0,0,41
1112702,24,0,0,0,0,0,0,24
1112703,51,3,3,0,0,0,0,57
1112704,0,0,0,0,0,0,0,0
1112705,20,0,0,0,0,0,0,20
1112706,37,9,6,0,0,0,0,52
1112707,19,4,4,0,0,0,0,27
1112708,30,6,4,0,0,0,0,40
1112709,40,0,0,0,0,0,0,40
1112710,73,3,4,0,0,0,0,80
1112711,26,3,6,0,0,0,0,35
1112712,43,3,3,0,0,0,0,49
1112801,34,3,0,4,0,0,0,41
1112802,46,0,0,4,0,0,0,50
1112803,30,3,3,0,0,0,0,36
1112804,43,0,3,0,0,0,0,46
1112805,54,3,3,0,0,0,3,63
1112806,60,3,6,0,0,0,3,72
1112807,37,4,3,0,0,0,0,44
1112808,45,0,4,0,0,0,0,49
1112809,56,0,4,0,0,0,0,60
1112810,90,5,3,0,0,0,0,98
1112811,36,9,3,3,0,0,0,51
1112812,43,6,0,0,0,0,0,49
1112813,36,3,0,0,0,0,0,39
1112901,22,4,0,0,0,0,0,26
1112902,62,3,3,0,0,0,3,71
1112903,63,6,4,0,0,0,0,73
1112904,40,4,3,0,0,0,3,50
1112905,24,0,0,0,0,0,0,24
1112906,35,0,0,0,0,0,0,35
1112907,33,7,0,0,0,0,0,40
1112908,23,3,3,0,0,0,0,29
1112909,38,4,0,0,0,0,0,42
1112910,32,4,4,0,0,0,0,40
1112911,21,0,4,0,0,0,0,25
1112912,24,0,0,0,0,0,3,27
1112913,46,0,0,0,0,0,3,49
1112914,19,0,3,0,0,0,0,22
1112915,15,3,3,0,0,0,0,21
1112916,29,0,3,0,0,0,3,35
1112917,27,0,3,3,0,0,0,33
1112918,28,0,3,0,0,0,0,31
1112919,17,3,0,3,0,0,0,23
1112920,31,0,3,3,0,0,0,37
1112921,31,0,3,0,0,0,0,34
1112922,29,7,3,0,0,0,0,39
1112923,50,6,4,0,0,0,3,63
1113001,25,0,0,3,0,0,0,28
1113002,83,4,3,0,0,0,0,90
1113003,31,3,3,0,0,0,0,37
1113004,42,0,5,0,0,0,0,47
1113005,49,7,3,0,0,0,0,59
1113006,58,3,3,0,0,0,0,64
1113007,48,5,0,0,0,0,0,53
1113008,61,7,0,0,0,0,0,68
1113009,35,3,3,3,0,0,0,44
1113010,41,3,3,0,0,0,0,47
1113011,17,3,0,0,0,0,3,23
1113012,29,3,0,0,0,0,0,32
1113013,77,3,3,3,0,0,0,86
1113014,48,0,4,0,0,0,0,52
1113015,30,4,3,0,0,0,0,37
1113016,44,0,0,0,0,0,0,44
1113017,41,0,3,0,0,3,0,47
1113018,3,0,0,0,0,0,0,3
1113019,41,0,0,0,0,0,0,41
1113020,33,0,0,0,0,0,0,33
1113021,52,3,3,0,0,0,0,58
1113022,44,6,0,0,0,0,0,50
1113023,37,7,4,0,0,0,0,48
1113024,44,0,0,0,0,0,0,44
1113025,43,5,0,0,0,0,0,48
1113026,33,0,3,0,0,0,3,39
1113027,50,0,0,0,0,0,0,50
1113028,51,3,3,0,0,3,0,60
1113029,42,0,4,0,0,0,0,46
1113030,39,0,3,3,0,0,3,48
1113031,54,5,3,3,0,0,3,68
1113032,23,5,4,0,0,0,0,32
1113033,53,0,4,0,0,0,0,57
1113034,33,3,5,0,0,0,0,41
1113035,0,0,0,0,0,0,0,0
1113036,14,0,0,0,0,0,0,14
1113037,0,0,0,0,0,0,0,0
1113038,22,4,0,0,0,0,0,26
1113039,3,0,0,0,0,0,0,3
1113040,41,0,0,0,0,0,0,41
1113041,101,5,0,0,0,0,3,109
1113042,42,0,0,0,0,0,0,42
1113043,24,0,7,0,0,0,0,31
1113044,31,3,3,3,0,0,3,43
1113045,32,3,0,0,0,0,0,35
1113046,65,3,5,0,0,0,0,73
1113047,12,8,3,0,0,0,0,23
1113048,45,3,3,0,0,0,0,51
1113049,50,3,5,0,0,0,0,58
1113050,33,4,6,3,0,0,0,46
1113051,0,0,0,0,0,0,0,0
1113052,35,3,3,0,0,0,0,41
1113053,34,9,3,0,0,0,4,50
1113054,28,3,0,0,0,0,0,31
1113055,48,3,3,0,0,0,0,54
1113056,0,0,0,0,0,0,0,0
1113057,51,5,3,0,0,0,0,59
1113058,20,4,0,0,0,0,0,24
1113059,31,8,10,0,0,0,0,49
1113060,26,4,4,0,0,0,4,38
1113061,39,4,4,0,0,0,0,47
1113062,43,5,0,0,0,0,0,48
1113063,58,5,4,0,0,0,0,67
1113064,18,3,0,0,0,0,0,21
1113065,50,0,4,0,0,0,0,54
1113066,31,4,0,0,0,0,0,35
1113067,18,0,0,0,0,0,0,18
1113101,21,4,3,0,0,0,0,28
1113102,32,3,3,0,0,0,3,41
1113103,21,5,6,0,0,0,0,32
1113104,22,4,4,0,0,0,0,30
1113105,43,8,0,0,0,0,3,54
1113106,35,0,3,0,0,0,0,38
1113107,38,5,3,0,0,0,0,46
1113108,37,6,0,0,0,0,0,43
1113109,54,12,3,0,0,0,0,69
1113110,25,0,0,3,0,0,0,28
1113111,53,0,3,0,0,0,0,56
1113112,0,0,0,0,0,0,0,0
1113113,50,4,0,0,0,0,0,54
1113114,101,16,3,0,0,0,0,120
1113115,62,3,3,0,0,4,0,72
1113116,16,5,4,0,0,0,0,25
1113117,61,8,3,0,0,0,0,72
1113118,42,3,5,0,0,0,4,54
1113119,59,5,0,0,0,0,0,64
1113120,43,3,0,0,3,0,0,49
1113121,25,0,0,0,3,0,0,28
1113122,18,3,4,0,0,0,0,25
1113123,37,3,3,0,0,0,0,43
1113124,33,3,3,3,0,3,3,48
1113125,31,4,0,0,0,0,0,35
1113126,34,3,4,3,0,0,3,47
1113127,70,7,3,0,0,3,0,83
1113128,61,4,6,0,0,0,0,71
1113129,43,3,5,0,0,0,0,51
1113130,32,6,3,0,0,0,0,41
1113131,38,5,3,0,0,0,0,46
1113132,28,6,4,0,0,0,0,38
1113133,30,3,0,0,0,0,0,33
1113134,32,10,0,0,0,0,5,47
1113135,28,3,3,0,0,0,0,34
1113136,32,0,0,0,0,0,0,32
1113137,77,5,8,0,0,0,0,90
1113138,45,0,0,0,0,0,0,45
1113139,25,3,0,0,0,0,0,28
1113140,29,7,3,0,0,0,0,39
1113141,21,0,3,0,0,0,0,24
1113142,26,4,0,0,0,0,0,30
1113143,70,4,3,0,0,0,0,77
1113144,32,13,3,0,0,0,0,48
1113145,31,3,3,0,0,0,0,37
1113146,47,7,5,0,0,0,0,59
1113147,50,3,3,0,0,0,0,56
1113148,54,5,4,0,0,0,0,63
1113149,26,0,0,0,0,0,0,26
1113150,58,5,6,0,0,0,3,72
1113151,27,3,3,0,0,0,3,36
1113152,47,4,0,3,0,0,0,54
1113153,22,4,0,0,0,0,0,26
1113154,33,6,3,0,0,0,0,42
1113155,24,3,0,0,0,0,0,27
1113156,12,0,0,0,0,0,0,12
1113157,40,3,3,0,0,0,0,46
1113158,46,9,3,0,0,0,0,58
1113201,51,6,0,0,0,0,0,57
1113202,35,8,0,0,0,0,3,46
1113203,43,3,3,0,0,0,0,49
1113204,85,3,3,0,0,0,0,91
1113205,43,9,3,0,0,0,0,55
1113206,56,3,6,0,0,0,0,65
1113207,54,4,4,0,0,0,0,62
1113208,23,0,3,3,0,0,0,29
1113209,21,0,0,3,0,0,0,24
1113210,52,3,3,0,0,0,0,58
1113211,95,4,4,0,0,0,0,103
1113212,43,3,3,0,0,0,0,49
1113213,63,8,3,3,3,0,0,80
1113214,82,5,6,0,0,0,0,93
1113215,70,8,7,0,0,0,0,85
1113216,47,3,3,0,0,0,0,53
1113217,64,13,5,3,0,0,0,85
1113218,35,5,3,0,0,0,0,43
1113219,38,4,5,0,0,0,0,47
1113301,0,0,0,0,0,0,0,0
1113401,0,0,0,0,0,0,0,0
1113402,68,4,3,0,0,0,0,75
1113403,68,0,3,5,0,0,0,76
1113404,56,3,3,0,0,0,0,62
1113405,32,3,0,0,0,0,0,35
1113406,44,3,3,3,0,0,3,56
1113407,34,4,4,0,0,0,0,42
1113408,48,3,0,3,0,0,0,54
1113409,43,0,0,0,0,0,0,43
1113410,59,0,3,0,0,0,3,65
1113411,53,3,0,0,0,0,0,56
1113412,48,0,0,0,0,0,0,48
1113413,39,3,3,0,0,0,0,45
1113414,45,5,0,0,0,0,0,50
1113415,49,4,0,0,0,0,3,56
1113416,42,3,3,3,0,0,0,51
1113417,20,0,0,0,0,0,0,20
1113418,32,7,3,0,0,0,0,42
1113419,61,3,0,0,0,0,0,64
1113420,41,9,4,0,0,0,0,54
1113421,43,5,3,0,0,0,0,51
1113422,99,3,3,0,0,0,3,108
1113423,51,3,0,0,0,0,0,54
1113424,103,3,0,0,0,0,0,106
1113425,27,4,0,0,0,0,3,34
1113426,50,0,5,3,0,0,3,61
1113427,31,0,0,0,0,0,0,31
1113428,35,0,0,0,0,0,0,35
1113429,33,8,0,0,0,0,0,41
1113430,23,0,7,0,0,0,0,30
1113431,42,3,3,0,0,0,0,48
1113432,47,3,4,0,0,0,0,54
1113433,35,3,6,3,0,0,0,47
1113434,64,3,4,0,0,0,0,71
1113435,54,0,3,0,0,0,0,57
1113436,54,0,0,0,0,0,0,54
1113437,12,5,3,0,0,0,0,20
1113438,36,4,3,0,0,0,0,43
1113439,23,6,0,0,0,0,3,32
1113440,43,3,3,0,0,0,0,49
1113441,0,0,0,0,0,0,0,0
1113442,81,5,0,0,0,0,0,86
1113443,47,3,3,0,0,0,0,53
1113444,46,3,0,3,0,0,0,52
1113445,32,4,0,0,0,0,0,36
1113501,0,0,0,0,0,0,0,0
1113601,56,11,3,0,0,0,0,70
1113602,46,3,3,3,0,0,0,55
1113603,45,4,3,0,0,0,0,52
1113604,43,3,0,3,0,0,0,49
1113605,33,3,3,0,0,0,4,43
1113606,22,0,0,0,0,0,0,22
1113607,57,3,0,0,0,0,0,60
1113608,20,3,3,0,0,0,0,26
1113609,73,0,8,0,0,0,0,81
1113610,94,7,7,0,0,0,0,108
1113611,57,0,6,0,0,0,0,63
1113612,47,7,6,0,0,0,0,60
1113613,55,9,4,0,0,0,0,68
1113614,68,4,4,0,0,0,0,76
1113615,102,9,4,0,0,0,0,115
1113616,0,0,0,0,0,0,0,0
1113617,56,5,3,0,0,0,0,64
1113618,54,7,4,0,0,0,0,65
1113619,42,3,3,3,0,3,0,54
1113620,51,4,5,0,0,0,0,60
1113621,38,10,3,0,0,0,0,51
1113622,76,3,5,4,0,0,3,91
1113623,52,3,8,4,0,0,0,67
1113624,52,0,4,0,0,0,0,56
1113625,67,6,0,0,0,0,0,73
1113626,26,6,3,0,0,0,0,35
1113627,23,3,0,0,0,0,0,26
1113628,40,11,0,0,0,0,0,51
1113629,38,3,3,0,0,0,0,44
1113630,53,7,0,0,0,0,0,60
1113631,28,3,3,0,0,0,0,34
1113632,36,3,4,4,0,0,0,47
1113633,65,4,3,0,0,0,0,72
1113634,38,3,3,0,0,0,0,44
1113635,76,7,3,0,0,0,0,86
1113701,19,3,0,3,0,0,0,25
1113702,66,6,7,0,0,0,0,79
1113703,0,0,0,0,0,0,0,0
1113704,29,6,3,0,0,0,0,38
1113705,41,4,3,0,0,0,0,48
1113706,55,10,3,0,0,0,0,68
1113707,32,0,4,0,0,0,0,36
1113708,33,4,0,0,0,0,0,37
1113709,34,4,4,0,0,0,0,42
1113710,23,5,0,4,0,0,0,32
1113711,37,3,3,0,0,0,3,46
1113712,45,8,0,0,0,0,0,53
1113713,46,7,3,3,0,0,0,59
1113714,31,10,0,3,0,0,0,44
1113715,41,6,5,0,0,0,0,52
1113716,34,0,0,0,0,0,0,34
1113717,26,3,4,0,0,0,0,33
1113718,42,5,5,0,0,0,0,52
1113719,0,0,0,0,0,0,0,0
1113720,0,0,0,0,0,0,0,0
1113721,3,0,0,0,0,0,0,3
1113722,19,3,3,4,0,3,0,32
1113801,28,4,3,0,0,0,0,35
1113802,13,3,0,0,0,0,0,16
1113803,25,4,0,0,0,0,0,29
1113804,44,3,0,0,0,0,0,47
1113805,10,0,0,0,0,0,0,10
1113806,40,7,0,0,0,0,0,47
1113807,26,3,3,0,0,0,0,32
1113808,19,3,0,0,0,0,0,22
1113809,42,4,3,4,0,0,0,53
1113810,24,0,3,0,0,0,0,27
1113811,60,4,0,0,0,0,0,64
1113812,42,0,5,0,0,0,0,47
1113813,40,3,3,3,0,0,0,49
1113814,14,4,0,0,0,0,0,18
1113815,55,6,0,0,0,0,0,61
1113816,28,0,0,0,0,0,0,28
1113817,29,4,0,0,0,0,0,33
1113818,17,0,0,0,0,0,0,17
1113819,4,0,0,0,0,0,0,4
1113820,54,5,0,0,0,0,0,59
1113821,55,6,3,0,0,0,0,64
1113901,0,0,0,0,0,0,4,4
1113902,0,0,0,0,0,0,0,0
1113903,27,4,0,0,0,0,0,31
1113904,66,5,3,0,0,3,0,77
1113905,68,3,6,0,0,0,0,77
1113906,49,3,0,0,0,0,0,52
1113907,43,5,0,0,0,0,0,48
1113908,70,5,3,0,0,0,0,78
1113909,51,3,3,0,0,0,0,57
1113910,35,6,0,0,0,0,0,41
1113911,0,0,0,0,0,0,0,0
1113912,55,0,0,0,0,0,0,55
1113913,24,7,3,0,0,0,0,34
1113914,52,3,3,0,0,0,0,58
1113915,40,6,0,0,0,0,0,46
1113916,45,3,4,0,0,0,0,52
1113917,26,4,0,0,0,0,0,30
1113918,0,0,0,0,0,0,0,0
1113919,45,6,3,0,0,0,0,54
1114001,74,3,5,0,0,0,0,82
1114002,18,0,0,0,0,0,0,18
1114003,44,3,3,0,0,0,0,50
1114004,45,0,0,0,0,0,0,45
1114005,24,0,0,0,0,0,0,24
1114006,60,3,3,0,0,0,0,66
1114007,78,4,5,3,0,0,4,94
1114008,29,0,3,0,0,0,0,32
1114009,50,4,0,0,0,0,0,54
1114010,36,3,0,0,0,0,0,39
1114011,39,5,0,0,0,0,0,44
1114012,31,0,3,0,0,0,0,34
1114013,37,5,0,0,0,0,0,42
1114014,20,0,0,0,0,0,0,20
1114015,25,3,0,0,0,0,0,28
1114016,14,4,0,0,0,0,0,18
1114017,46,5,0,5,0,0,0,56
1114018,31,0,0,0,0,0,0,31
1114019,32,0,3,0,0,0,0,35
1114020,23,0,0,0,0,0,0,23
1114101,77,8,7,0,0,0,0,92
1114102,0,0,0,0,0,0,0,0
1114103,23,3,0,0,0,0,0,26
1114104,50,6,4,0,0,0,0,60
1114105,34,0,0,0,0,0,0,34
1114106,64,4,3,0,0,0,0,71
1114107,52,0,0,0,0,0,0,52
1114108,59,4,3,0,0,0,0,66
1114109,128,15,7,0,0,0,0,150
1114110,55,4,3,4,0,0,0,66
1114111,0,0,0,0,0,0,0,0
1114112,67,4,3,0,0,0,0,74
1114113,49,0,3,0,0,0,0,52
1114114,53,5,0,0,0,0,0,58
1114115,37,4,0,0,0,0,0,41
1114116,66,7,5,0,0,0,0,78
1114117,46,6,3,0,0,0,0,55
1114118,37,0,4,0,0,0,0,41
1114119,70,9,3,3,0,0,0,85
1114120,53,6,0,0,0,0,0,59
1114121,33,3,0,0,0,0,0,36
1114122,42,8,3,0,0,0,5,58
1114123,96,0,3,0,0,0,0,99
1114124,30,0,3,0,0,0,0,33
1114125,98,10,5,0,0,0,0,113
1114126,19,0,0,0,0,0,0,19
1114127,62,4,0,0,0,0,4,70
1114128,84,6,4,5,0,0,0,99
1114129,47,5,3,0,0,3,0,58
1114130,87,10,4,0,0,0,0,101
1114131,65,3,0,0,0,0,0,68
1114132,77,7,4,0,0,0,3,91
1114201,72,3,3,0,0,0,0,78
1114202,54,3,0,0,0,0,0,57
1114203,0,0,0,0,0,0,0,0
1114204,38,0,0,0,0,0,0,38
1114205,60,0,3,0,0,0,0,63
1114206,48,4,3,0,0,0,0,55
1114207,46,0,6,0,0,0,0,52
1114208,43,7,3,0,0,0,0,53
1114209,28,0,0,0,0,0,0,28
1114210,24,0,5,0,0,0,0,29
1114211,40,5,6,0,0,0,0,51
1114212,59,5,0,0,0,0,0,64
1114213,59,3,0,0,0,0,0,62
1114214,33,3,5,0,0,0,0,41
1114215,30,3,0,0,0,0,0,33
1114216,50,4,0,0,0,0,0,54
1114217,51,6,0,0,0,0,0,57
1114218,55,6,0,0,0,0,3,64
1114219,27,0,3,0,0,0,0,30
1114220,39,9,3,0,0,0,3,54
1114221,3,3,0,0,0,0,0,6
1114222,44,5,8,4,0,0,0,61
1114223,42,5,0,0,0,0,0,47
1114224,32,0,3,0,0,4,0,39
1114225,64,0,3,0,0,0,0,67
1114226,51,3,3,0,0,0,3,60
1114301,16,6,5,3,0,0,0,30
1114302,51,8,3,0,0,0,0,62
1114303,39,3,3,0,0,0,0,45
1114304,32,4,0,0,0,0,0,36
1114305,33,0,0,0,0,0,0,33
1114306,49,0,3,3,0,0,0,55
1114307,48,0,3,0,0,0,0,51
1114308,22,3,3,0,0,0,0,28
1114309,35,3,4,0,0,0,3,45
1114310,39,3,4,3,0,0,0,49
1114311,26,4,3,0,0,0,4,37
1114312,0,0,0,0,0,0,0,0
1114313,41,4,4,0,0,0,0,49
1114314,6,0,0,0,0,0,0,6
1114315,38,6,0,0,0,0,0,44
1114316,39,4,3,0,0,0,0,46
1114317,52,3,5,3,0,0,0,63
1114318,47,7,0,0,0,0,0,54
1114319,65,3,3,0,0,0,0,71
1114320,35,5,3,3,0,0,3,49
1114321,55,9,3,0,0,3,0,70
1114322,28,9,3,0,0,0,0,40
1114323,43,5,0,0,0,0,0,48
1114324,22,4,0,0,0,0,0,26
1114325,26,9,6,0,0,0,0,41
1114326,42,6,0,0,0,0,0,48
1114327,20,3,3,0,0,0,0,26
1114328,27,3,3,0,0,0,0,33
1114329,18,0,3,0,0,0,0,21
1114330,33,3,0,0,0,0,0,36
1114331,32,0,4,0,0,0,0,36
1114332,29,4,0,0,0,0,0,33
1114333,12,3,4,0,0,0,0,19
1114334,47,7,3,3,0,0,0,60
1114335,40,3,3,0,0,0,0,46
1114336,42,0,6,0,0,0,0,48
1114337,31,3,3,4,0,0,0,41
1114338,22,3,6,0,0,0,3,34
1114339,31,10,5,0,0,0,0,46
1114340,23,4,0,0,0,0,0,27
1114341,18,0,0,0,0,0,0,18
1114342,21,3,7,0,0,0,0,31
1114343,18,0,0,0,0,0,0,18
1114344,61,11,5,0,0,0,0,77
1114345,44,5,5,0,0,0,0,54
1114346,49,5,0,5,0,0,0,59
1114347,43,0,4,4,0,0,0,51
1114348,37,4,0,0,0,0,0,41
1114349,46,9,0,3,0,0,0,58
1114350,58,6,0,0,0,0,0,64
1114401,53,0,4,0,0,0,0,57
1114402,93,5,0,0,0,0,0,98
1114403,17,0,0,0,0,0,0,17
1114404,55,5,3,0,0,0,0,63
1114405,29,3,3,3,0,0,0,38
1114406,48,0,3,0,0,0,0,51
1114407,64,0,0,0,0,0,0,64
1114408,27,3,3,0,0,0,0,33
1114409,30,5,0,0,0,0,0,35
1114410,32,0,0,0,0,0,0,32
1114411,38,10,0,0,0,0,3,51
1114412,8,0,0,0,0,0,0,8
1114413,35,3,0,0,0,0,0,38
1114414,52,3,3,0,0,0,0,58
1114415,4,3,3,0,0,0,0,10
1114416,24,3,3,0,0,0,0,30
1114417,55,10,0,0,0,0,0,65
1114418,0,0,0,0,0,0,0,0
1114419,32,3,0,0,0,0,0,35
1114420,16,0,0,0,0,0,0,16
1114421,45,0,3,0,0,0,0,48
1114422,56,6,0,3,0,0,0,65
1114423,70,7,6,0,0,0,0,83
1114424,66,0,6,0,0,0,0,72
1114425,51,5,3,0,0,0,0,59
1114426,67,0,3,5,0,0,0,75
1114427,31,0,0,0,0,0,0,31
1114428,59,4,4,0,0,0,0,67
1114429,38,5,0,0,0,0,0,43
1114430,36,3,3,0,0,0,0,42
1114431,72,4,0,3,0,0,0,79
1114432,69,3,0,0,0,0,0,72
1114433,63,3,5,0,0,0,0,71
1114434,49,0,3,0,0,0,0,52
1114435,34,3,4,0,0,0,0,41
1114436,24,3,0,0,0,0,0,27
1114437,43,4,3,0,0,0,0,50
1114438,33,3,0,0,0,0,0,36
1114439,44,3,0,0,0,0,0,47
1114440,51,6,0,0,0,0,0,57
1114441,33,5,5,0,0,0,0,43
1114442,41,5,3,0,0,0,0,49
1114443,51,3,3,0,0,0,0,57
1114444,59,3,0,0,0,0,0,62
1114445,60,4,3,0,0,0,3,70
1114446,28,0,0,3,0,0,0,31
1114447,50,3,0,3,0,0,0,56
1114448,30,0,3,0,0,0,0,33
1114501,30,0,3,0,0,0,0,33
1114502,57,7,0,0,0,0,0,64
1114503,55,3,3,0,0,0,0,61
1114504,45,3,3,0,0,0,3,54
1114505,55,0,0,4,0,0,0,59
1114506,0,0,0,0,0,0,0,0
1114507,27,4,0,0,0,0,0,31
1114508,53,0,0,0,0,0,0,53
1114509,46,0,0,0,0,0,0,46
1114510,52,5,0,0,0,0,0,57
1114511,41,3,0,0,0,0,0,44
1114512,41,4,3,0,0,0,0,48
1114513,18,3,0,0,0,0,0,21
1114514,39,4,0,0,0,0,0,43
1114515,30,3,0,0,0,0,0,33
1114516,56,3,3,0,0,0,0,62
1114517,23,3,3,0,0,0,0,29
1114518,50,4,0,0,0,0,0,54
1114519,31,3,0,3,0,0,0,37
1114520,49,7,3,0,0,0,0,59
1114521,24,3,3,0,0,3,0,33
1114522,27,4,0,0,0,0,0,31
1114523,29,5,3,0,0,0,0,37
1114524,36,4,0,0,0,0,0,40
1114525,38,0,0,0,0,0,0,38
1114526,50,0,0,0,0,0,0,50
1114527,22,3,0,4,0,0,0,29
1114528,19,7,3,3,0,0,0,32
1114529,16,0,7,0,0,0,3,26
1114530,4,0,0,0,0,0,0,4
1114531,35,3,0,0,0,0,0,38
1114532,25,0,3,0,0,0,3,31
1114533,56,3,0,3,0,0,0,62
1114534,43,3,4,3,0,0,0,53
1114535,36,3,0,0,0,0,0,39
1114536,22,0,3,0,0,0,0,25
1114537,26,4,0,0,0,0,0,30
1114538,45,6,3,0,0,0,0,54
1114539,62,3,0,0,0,0,0,65
1114601,22,3,3,0,0,0,0,28
1114602,36,3,3,0,0,0,0,42
1114603,49,0,0,0,0,0,0,49
1114604,30,0,0,0,0,0,0,30
1114605,46,0,0,0,0,0,0,46
1114606,64,7,0,0,0,0,0,71
1114607,59,0,0,0,0,0,0,59
1114608,51,6,0,0,0,0,0,57
1114609,80,8,3,0,0,0,0,91
1114610,76,6,3,0,0,0,0,85
1114611,59,0,3,3,0,0,0,65
1114612,35,3,3,0,0,0,0,41
1114613,27,0,0,0,0,0,0,27
1114614,73,11,3,0,0,0,0,87
1114615,32,0,0,0,0,0,0,32
1114616,55,3,0,0,0,0,0,58
1114617,35,0,3,0,3,0,0,41
1114618,23,0,0,0,0,0,0,23
1114619,30,0,0,0,0,0,0,30
1114620,28,0,0,0,0,0,0,28
1114621,31,0,4,0,0,0,0,35
1114622,53,3,0,4,0,0,0,60
1114623,51,7,0,0,0,0,0,58
1114624,49,0,0,0,0,0,0,49
1114625,69,3,3,0,0,0,0,75
1114626,113,3,3,0,0,0,0,119
1114627,77,5,0,0,0,0,0,82
1114628,48,3,3,0,0,0,3,57
1114629,50,3,3,0,0,0,0,56
1114630,91,5,0,0,0,0,3,99
1114631,44,3,0,0,0,0,0,47
1114632,48,3,3,0,0,0,0,54
1114633,28,0,0,0,0,0,0,28
1114634,61,0,5,0,0,0,0,66
1114635,75,5,3,0,0,0,0,83
1114636,50,6,4,0,0,0,0,60
1114637,90,5,4,0,0,0,0,99
1114638,4,0,0,0,0,0,0,4
1114639,5,3,0,0,0,0,0,8
1114640,58,3,3,0,0,0,4,68
1114641,33,4,4,0,0,0,0,41
1114642,41,0,0,0,0,0,0,41
1114643,47,3,3,0,0,0,0,53
1114644,47,0,0,0,0,0,0,47
1114645,65,3,5,0,0,0,0,73
1114646,57,3,3,0,0,0,0,63
1114701,85,3,10,0,0,0,0,98
1114702,83,7,9,0,0,0,0,99
1114703,38,3,3,0,0,0,0,44
1114704,57,0,0,0,0,0,0,57
1114705,49,3,3,0,0,0,0,55
1114706,50,0,0,0,0,0,0,50
1114707,0,0,0,0,0,0,0,0
1114708,66,8,3,3,0,0,0,80
1114709,48,4,3,0,0,0,0,55
1114710,3,0,0,0,0,0,0,3
1114711,74,0,3,0,0,0,0,77
1114712,70,3,0,0,0,0,0,73
1114713,97,4,3,0,0,0,0,104
1114714,24,4,3,0,0,0,0,31
1114715,26,0,0,0,0,0,0,26
1114716,14,3,0,0,0,0,0,17
1114717,6,0,0,0,0,0,0,6
1114718,44,5,0,0,0,0,0,49
1114719,35,4,3,0,0,0,0,42
1114720,50,4,0,0,0,0,0,54
1114721,63,4,4,0,0,0,0,71
1114722,74,3,0,0,0,0,0,77
1114723,92,0,0,0,0,0,0,92
1114724,62,5,3,0,0,0,0,70
1114801,58,5,0,0,0,0,0,63
1114802,66,0,4,0,0,0,0,70
1114803,45,4,3,0,0,0,0,52
1114804,53,4,4,0,0,0,0,61
1114805,44,4,3,0,0,0,0,51
1114806,0,0,0,0,0,0,0,0
1114807,39,0,3,0,0,0,0,42
1114808,45,3,3,0,0,0,0,51
1114809,45,0,0,0,0,0,0,45
1114810,50,4,3,0,0,0,0,57
1114811,62,4,0,0,0,0,0,66
1114812,0,0,0,0,0,0,0,0
1114813,51,4,0,0,0,3,0,58
1114814,14,0,4,0,0,0,0,18
1114815,36,0,4,0,0,0,0,40
1114816,39,4,0,0,0,0,0,43
1114817,0,0,0,0,0,0,0,0
1114818,22,0,0,0,0,0,0,22
1114819,34,3,0,0,0,0,0,37
1114820,32,0,0,0,0,0,0,32
1114821,57,4,3,0,0,0,0,64
1114822,38,3,0,0,0,0,0,41
1114823,41,3,0,0,0,0,0,44
1114824,53,3,0,0,0,0,0,56
1114825,46,3,3,0,0,0,0,52
1114826,87,7,9,0,0,0,0,103
1114827,71,4,4,0,0,0,0,79
1114828,35,3,3,0,0,0,0,41
1114829,21,4,0,0,0,0,0,25
1114830,54,0,3,0,0,0,0,57
1114831,64,4,0,0,0,0,0,68
1114901,0,0,0,0,0,0,0,0
1114902,70,0,3,0,0,0,0,73
1114903,27,0,3,0,0,0,0,30
1114904,19,3,0,0,0,0,0,22
1114905,33,3,3,0,0,0,0,39
1114906,18,3,0,0,0,0,0,21
1114907,52,3,0,0,0,0,0,55
1114908,48,3,3,0,0,0,0,54
1114909,49,3,3,0,0,0,0,55
1114910,34,0,0,0,0,0,0,34
1114911,46,8,3,0,3,0,0,60
1114912,43,0,3,0,0,0,0,46
1114913,13,3,0,0,0,0,0,16
1114914,36,3,4,0,0,0,0,43
1114915,36,3,0,0,0,0,0,39
1114916,46,4,0,0,0,0,0,50
1114917,41,3,0,0,0,0,3,47
1114918,9,4,0,0,0,0,0,13
1114919,24,4,0,0,0,0,0,28
1114920,19,0,0,0,0,0,0,19
1114921,23,4,0,0,0,0,0,27
1114922,30,3,0,3,0,0,0,36
1114923,46,0,0,0,0,0,0,46
1114924,35,3,3,3,0,0,0,44
1114925,45,3,0,0,0,0,0,48
1114926,35,3,3,0,0,0,0,41
1114927,31,0,4,0,0,0,0,35
1114928,42,6,3,0,0,0,0,51
1114929,33,0,0,0,0,0,0,33
1114930,34,0,4,0,0,0,0,38
1114931,25,3,3,3,0,0,0,34
1114932,30,4,0,0,0,0,0,34
1114933,47,5,0,0,0,0,0,52
1114934,52,3,0,4,0,0,0,59
1114935,47,0,3,3,0,0,0,53
1114936,41,6,0,0,0,0,0,47
1114937,20,0,0,0,0,0,0,20
1114938,13,3,0,0,0,0,0,16
1114939,68,8,3,0,0,0,0,79
1114940,0,0,0,0,0,0,0,0
1114941,26,0,3,0,0,0,0,29
1114942,37,3,3,0,0,0,0,43
1114943,52,4,3,0,0,0,0,59
1114944,32,4,0,4,0,0,0,40
1114945,11,3,0,0,0,0,0,14
1114946,30,0,0,0,0,0,0,30
1114947,9,0,3,0,0,0,0,12
1114948,30,0,0,0,0,0,0,30
1114949,20,4,0,0,0,0,0,24
1114950,12,0,3,0,0,0,0,15
1114951,16,4,0,0,0,0,0,20
1114952,21,8,3,0,0,0,0,32
1114953,31,0,0,0,0,0,0,31
1114954,19,7,0,0,0,0,0,26
1114955,17,3,0,0,0,0,0,20
1114956,31,0,3,0,0,0,0,34
1114957,36,4,4,0,3,0,0,47
1114958,36,3,5,0,0,0,0,44
1114959,36,6,4,0,0,0,0,46
1114960,39,0,7,0,0,0,0,46
1114961,48,0,4,0,0,0,0,52
1115001,35,4,0,0,0,0,0,39
1115002,64,3,3,0,0,0,0,70
1115003,66,7,4,3,0,0,0,80
1115004,51,5,0,0,0,0,0,56
1115005,47,3,7,0,0,0,0,57
1115006,90,9,4,0,0,0,0,103
1115007,46,4,0,0,0,0,0,50
1115008,29,3,5,0,0,0,0,37
1115009,30,3,3,0,0,0,0,36
1115010,27,4,0,0,0,0,0,31
1115011,54,3,3,3,0,0,0,63
1115012,26,0,3,0,0,0,0,29
1115013,28,3,3,0,0,0,0,34
1115014,66,3,6,0,0,0,0,75
1115015,60,5,0,0,0,0,0,65
1115016,23,4,0,0,0,0,0,27
1115017,79,7,0,0,0,0,0,86
1115018,40,5,0,0,0,0,0,45
1115019,56,0,3,0,0,0,0,59
1115020,37,0,3,3,0,0,0,43
1115021,41,3,0,0,0,0,0,44
1115022,85,0,5,0,0,0,0,90
1115023,62,7,3,0,0,0,0,72
1115024,27,3,4,0,0,0,0,34
1115025,30,3,3,0,0,0,0,36
1115026,29,6,4,0,0,0,0,39
1115027,58,5,3,0,0,0,0,66
1115028,19,0,0,0,0,0,0,19
1115029,57,4,4,0,0,0,4,69
1115030,65,4,0,3,0,0,0,72
1115031,78,4,3,0,0,0,0,85
1115032,43,3,0,0,0,0,0,46
1115033,67,3,3,0,0,0,0,73
1115034,39,0,0,0,0,0,0,39
1115035,60,7,3,0,0,0,0,70
1115036,89,8,4,0,0,0,0,101
1115037,37,3,0,0,0,0,0,40
1115038,40,3,0,0,0,0,0,43
1115039,39,0,3,0,0,0,0,42
1115040,52,10,3,0,0,0,0,65
1115041,56,6,0,3,0,0,0,65
1115042,68,3,3,0,0,0,0,74
1115043,3,0,0,0,0,0,0,3
1115044,31,3,4,0,0,0,0,38
1115101,44,0,5,0,0,0,0,49
1115102,9,3,3,0,0,0,3,18
1115103,34,0,0,0,0,0,3,37
1115104,35,0,0,0,0,0,3,38
1115105,23,8,0,0,0,0,0,31
1115106,20,3,0,0,0,0,0,23
1115107,17,0,0,0,0,0,0,17
1115108,45,3,0,0,0,0,0,48
1115109,23,3,0,0,0,0,0,26
1115110,45,5,0,0,0,0,4,54
1115111,70,5,7,0,0,0,0,82
1115112,50,0,0,0,0,0,4,54
1115113,0,0,0,0,0,0,0,0
1115114,31,10,6,0,0,0,0,47
1115201,53,3,0,0,0,0,0,56
1115202,27,3,3,0,0,0,0,33
1115203,28,3,3,0,0,0,3,37
1115204,12,5,0,0,0,0,0,17
1115205,23,4,3,0,0,0,3,33
1115206,30,3,0,3,0,0,3,39
1115207,27,3,0,0,0,0,0,30
1115208,43,3,0,0,0,0,0,46
1115209,19,0,0,0,0,0,0,19
1115210,38,3,3,0,0,0,0,44
1115211,36,3,3,0,0,0,0,42
1115212,10,3,0,0,0,0,0,13
1115213,23,5,3,0,0,0,0,31
1115214,43,6,0,0,0,0,0,49
1115215,0,0,0,0,0,0,0,0
1115216,39,3,3,0,0,0,0,45
1115217,14,0,3,0,0,0,0,17
1115218,22,5,3,0,0,0,0,30
1115219,16,0,4,0,0,3,0,23
1115220,14,4,0,0,0,0,0,18
1115221,24,6,3,0,0,0,0,33
1115222,15,0,0,0,0,0,0,15
1115223,0,0,0,0,0,0,0,0
1115224,3,3,0,0,0,0,0,6
1115225,31,0,0,0,0,5,0,36
1115226,29,0,0,0,0,0,0,29
1115227,6,0,3,0,0,0,0,9
1115228,25,4,0,3,0,0,0,32
1115229,32,3,3,0,0,0,0,38
1115230,36,3,8,0,0,0,0,47
1115231,34,5,4,0,0,0,0,43
1115232,19,4,0,0,0,0,4,27
1115233,59,10,3,0,0,0,0,72
1115234,10,0,0,0,0,0,0,10
1115235,35,0,0,0,0,0,0,35
1115236,20,0,3,0,0,0,0,23
1115301,36,5,3,0,0,0,0,44
1115302,17,0,0,0,0,0,0,17
1115303,53,3,3,4,0,0,4,67
1115304,47,4,0,3,0,0,0,54
1115305,11,0,0,0,0,0,0,11
1115306,8,0,0,0,0,0,0,8
1115307,44,4,0,0,0,0,0,48
1115308,20,0,0,0,0,0,0,20
1115309,19,3,0,0,0,0,0,22
1115310,24,0,0,0,0,0,0,24
1115311,29,9,0,0,0,0,0,38
1115312,19,3,0,0,0,0,0,22
1115313,33,3,3,0,0,0,0,39
1115314,18,4,0,0,0,0,0,22
1115315,30,3,3,0,0,0,0,36
1115316,44,10,7,0,0,0,3,64
1115401,11,0,0,0,0,0,0,11
1115402,0,0,0,0,0,0,0,0
1115403,3,0,0,0,0,0,0,3
1115404,3,0,3,0,0,0,0,6
1115405,42,0,3,0,0,0,0,45
1115406,11,0,0,0,0,0,0,11
1115407,12,3,0,0,0,0,0,15
1115408,26,3,3,0,0,0,0,32
1115409,4,0,0,0,0,0,4,8
1115410,15,0,0,0,0,3,0,18
1115411,23,0,3,0,0,0,0,26
1115412,30,0,0,0,0,0,0,30
1115413,26,4,3,0,0,0,0,33
1115414,32,0,5,0,0,0,0,37
1115415,5,0,3,0,0,0,0,8
1115416,13,0,0,0,0,0,3,16
1115417,0,0,0,0,0,0,0,0
1115418,10,7,0,0,0,0,0,17
1115419,15,3,0,0,0,0,0,18
1115501,53,0,4,0,0,0,4,61
1115502,27,4,0,4,0,0,3,38
1115503,25,3,3,0,0,0,0,31
1115504,43,3,3,0,0,0,0,49
1115505,8,0,3,0,0,0,3,14
1115506,13,0,0,0,0,0,3,16
1115507,15,5,0,0,0,0,0,20
1115508,21,5,0,0,0,0,0,26
1115509,45,0,0,0,0,0,0,45
1115510,35,3,3,0,0,0,0,41
1115511,25,0,3,3,0,0,0,31
1115512,34,6,0,0,0,0,0,40
1115513,26,0,0,0,0,0,0,26
1115514,26,4,4,0,0,0,0,34
1115515,33,4,0,0,0,0,0,37
1115516,12,3,4,3,0,0,0,22
1115517,8,3,0,3,0,0,3,17
1115518,22,0,5,0,0,0,0,27
1115519,21,4,0,4,0,0,0,29
1115520,10,0,0,0,0,0,0,10
1115521,30,3,4,0,0,0,0,37
1115522,35,3,0,3,0,0,0,41
1115523,24,0,3,0,0,0,0,27
1115524,34,4,0,0,0,0,0,38
1115525,14,3,0,0,0,0,0,17
1115526,30,3,3,0,0,0,0,36
1115527,32,4,0,3,0,0,0,39
1115528,26,0,0,0,0,0,0,26
1115529,23,3,5,0,0,0,3,34
1115530,35,0,0,0,0,0,0,35
1115531,28,4,0,0,0,0,0,32
1115532,57,7,4,0,0,0,0,68
1115533,20,3,3,0,0,0,0,26
1115534,25,3,3,0,0,0,0,31
1115535,0,0,0,0,0,0,0,0
1115536,18,3,4,0,0,0,0,25
1115537,0,0,0,0,0,0,0,0
1115538,18,0,4,0,0,0,0,22
1115539,5,3,0,3,0,0,0,11
1115540,28,0,0,5,0,0,0,33
1115601,15,0,0,0,0,0,0,15
1115602,24,0,4,0,0,3,0,31
1115603,16,3,0,0,0,0,0,19
1115604,26,3,0,0,0,0,0,29
1115605,31,0,0,0,0,0,0,31
1115606,20,0,5,0,0,0,0,25
1115607,18,3,0,3,0,0,0,24
1115608,22,4,4,0,0,0,0,30
1115609,32,0,0,3,0,0,3,38
1115610,15,5,0,0,0,3,0,23
1115611,35,3,3,0,0,0,0,41
1115612,41,3,3,0,0,0,3,50
1115613,29,3,3,0,0,0,3,38
1115614,28,0,0,0,0,0,0,28
1115615,31,0,0,0,0,0,0,31
1115616,13,0,0,0,0,0,0,13
1115617,11,0,0,3,0,0,0,14
1115618,10,0,0,0,0,0,0,10
1115619,23,0,7,0,0,0,0,30
1115620,39,3,8,0,0,0,3,53
1115621,26,3,0,0,0,0,0,29
1115622,26,7,4,0,0,0,0,37
1115623,39,0,4,0,0,0,3,46
1115624,54,3,9,0,0,0,0,66
1115625,20,3,0,0,0,0,0,23
1115626,33,0,3,0,0,0,0,36
1115627,18,3,3,0,0,0,0,24
1115628,17,4,3,0,0,0,0,24
1115701,31,3,3,0,0,0,0,37
1115702,12,3,4,0,0,0,0,19
1115703,18,3,0,0,0,0,3,24
1115704,25,4,5,0,0,0,0,34
1115705,17,3,0,0,0,0,0,20
1115706,19,0,5,0,0,0,4,28
1115707,10,0,0,4,0,0,0,14
1115708,25,0,0,0,0,0,0,25
1115709,32,0,0,0,0,0,0,32
1115710,10,0,0,0,0,0,0,10
1115711,23,0,3,0,0,0,0,26
1115712,18,3,3,0,0,0,0,24
1115713,27,0,0,0,3,0,0,30
1115714,40,4,3,0,0,0,0,47
1115715,14,0,0,0,0,0,0,14
1115801,13,3,0,0,0,0,0,16
1115802,15,3,0,0,0,0,0,18
1115803,13,5,0,0,0,0,0,18
1115804,41,0,0,0,0,0,0,41
1115805,13,3,3,0,0,0,0,19
1115806,18,3,0,0,0,0,0,21
1115807,0,0,0,0,0,0,0,0
1115808,0,0,0,0,0,0,0,0
1115809,11,0,0,0,0,0,0,11
1115810,34,0,0,0,0,0,0,34
1115811,43,4,4,0,0,0,0,51
1115812,0,0,0,0,0,0,0,0
1115813,17,3,3,0,0,0,0,23
1115814,33,4,7,0,0,0,0,44
1115815,24,0,0,0,0,0,3,27
1115816,22,6,0,0,0,0,0,28
1115817,16,0,4,0,0,0,0,20
1115818,29,3,0,0,0,0,0,32
1115819,18,0,3,0,0,3,0,24
1115901,26,4,5,0,0,0,0,35
1115902,25,0,0,0,0,0,0,25
1115903,43,3,4,0,0,0,0,50
1115904,8,0,0,0,0,0,0,8
1115905,82,8,4,0,0,3,0,97
1115906,36,0,8,0,0,0,0,44
1115907,24,0,0,0,0,0,0,24
1115908,40,7,0,0,0,0,0,47
1115909,51,7,0,3,0,0,0,61
1115910,24,3,3,0,0,0,0,30
1115911,39,7,3,0,0,0,0,49
1115912,24,3,3,0,0,0,0,30
1115913,15,0,0,0,0,0,3,18
1115914,22,5,4,0,0,0,0,31
1115915,24,0,0,0,0,0,0,24
1115916,23,4,3,0,0,0,0,30
1115917,23,0,0,0,0,0,3,26
1115918,15,0,4,0,0,0,0,19
1115919,4,0,0,0,0,0,0,4
1115920,25,0,3,0,0,0,3,31
1115921,11,0,0,3,0,0,0,14
1115922,21,0,0,0,0,0,0,21
1116001,24,5,0,0,0,0,0,29
1116002,14,4,0,0,0,0,0,18
1116003,16,4,0,0,0,0,0,20
1116004,9,0,5,0,0,0,0,14
1116005,20,3,3,3,0,0,0,29
1116006,38,0,4,0,0,0,0,42
1116007,27,0,0,0,0,0,0,27
1116008,8,3,0,0,0,0,0,11
1116009,33,4,3,0,0,0,0,40
1116010,0,0,0,0,0,0,0,0
1116011,14,6,0,0,0,0,0,20
1116012,0,0,0,0,0,0,0,0
1116013,32,4,3,0,0,3,0,42
1116014,27,4,0,0,0,0,0,31
1116015,10,3,3,0,0,0,0,16
1116016,16,0,0,0,0,0,3,19
1116017,41,4,0,0,0,0,0,45
1116101,36,0,0,0,0,0,0,36
1116201,53,4,4,0,0,0,0,61
1116202,21,4,0,0,0,0,0,25
1116203,45,0,0,0,0,0,4,49
1116204,65,3,8,0,0,0,0,76
1116205,10,4,3,0,0,0,0,17
1116206,41,4,4,0,0,4,0,53
1116207,19,0,0,0,0,0,4,23
1116208,10,3,3,0,0,0,0,16
1116209,22,0,3,0,0,0,3,28
1116210,71,5,5,0,0,0,0,81
1116211,38,3,3,0,0,0,0,44
1116212,19,0,0,4,0,0,0,23
1116213,4,0,0,0,0,0,3,7
1116214,24,4,0,0,0,0,0,28
1116215,29,3,5,0,0,0,0,37
1116216,17,3,0,0,0,0,0,20
1116217,27,3,0,0,0,0,0,30
1116218,52,5,4,0,0,0,0,61
1116219,23,4,0,0,0,0,0,27
1116220,30,4,3,0,0,0,0,37
1116221,16,3,0,0,0,0,0,19
1116222,10,6,0,0,0,0,0,16
1116223,26,4,0,0,0,0,0,30
1116224,13,4,0,0,0,0,0,17
1116225,15,0,5,0,0,0,0,20
1116226,0,0,0,0,0,0,0,0
1116227,19,0,0,0,0,0,0,19
1116228,18,3,0,0,0,0,0,21
1116229,51,0,4,0,0,0,0,55
1116230,42,11,0,0,0,0,0,53
1116231,11,0,3,0,0,0,0,14
1116232,18,3,4,0,0,0,0,25
1116233,0,0,0,0,0,0,0,0
1116234,26,3,0,0,0,0,0,29
1116235,18,4,0,0,0,0,0,22
1116236,38,0,0,0,0,0,0,38
1116237,62,0,3,0,0,0,3,68
1116238,6,0,0,0,0,0,0,6
1116239,19,0,3,0,0,0,3,25
1116240,0,0,0,0,0,0,0,0
1116241,20,3,3,0,0,0,0,26
1116242,13,0,3,0,0,0,0,16
1116243,28,3,0,0,0,0,3,34
1116244,23,3,0,0,0,0,3,29
1116245,20,0,0,0,0,0,0,20
1116246,23,3,3,3,0,0,0,32
1116247,10,3,0,4,0,0,0,17
1116248,32,0,0,0,0,0,0,32
1116249,23,0,0,0,0,0,0,23
1116250,0,0,0,0,0,0,0,0
1116251,13,0,0,0,0,0,0,13
1116301,46,5,0,0,0,0,0,51
1116302,30,3,0,0,0,0,0,33
1116303,18,4,0,0,0,0,0,22
1116304,25,0,3,0,0,0,0,28
1116305,23,7,4,0,0,0,0,34
1116306,23,3,3,0,0,0,0,29
1116307,37,4,6,0,0,0,0,47
1116308,63,9,4,0,0,0,0,76
1116309,41,3,0,3,0,0,0,47
1116310,28,4,0,0,0,0,0,32
1116311,60,5,0,0,0,0,0,65
1116312,61,6,3,0,0,0,0,70
1116313,33,6,3,0,0,0,3,45
1116314,29,0,4,0,0,0,0,33
1116315,11,4,0,0,0,0,0,15
1116316,11,0,0,0,0,0,0,11
1116317,19,0,0,0,0,0,0,19
1116318,31,5,3,0,0,0,0,39
1116319,0,0,0,0,0,0,0,0
1116320,23,0,0,0,0,0,0,23
1116321,26,0,5,0,0,0,0,31
1116322,22,3,0,0,0,0,0,25
1116323,16,0,0,0,0,0,0,16
1116324,27,0,0,0,0,0,0,27
1116325,0,0,0,0,0,0,0,0
1116326,52,3,3,0,0,0,0,58
1116327,54,5,0,0,0,0,0,59
1116328,34,3,0,0,0,0,0,37
1116329,35,3,0,0,0,0,0,38
1116330,24,3,3,0,0,0,0,30
1116331,31,3,0,0,0,0,0,34
1116332,37,8,4,0,0,0,0,49
1116333,27,6,0,3,0,0,3,39
1116334,20,5,3,0,0,0,0,28
1116335,11,0,0,0,0,0,0,11
1116336,19,3,0,0,0,0,0,22
1116337,41,10,4,0,0,0,0,55
1116338,46,4,0,0,0,0,0,50
1116339,52,3,3,0,0,0,0,58
1116340,29,0,0,0,0,0,0,29
1116341,74,7,3,0,0,0,0,84
1116342,65,4,3,0,0,0,0,72
1116343,47,0,0,4,0,0,0,51
1116344,23,3,3,0,0,0,0,29
1116345,35,5,4,0,0,0,0,44
1116346,37,8,4,0,0,0,0,49
1116347,23,7,0,0,0,0,0,30
1116348,29,4,0,0,0,0,0,33
1116349,44,4,3,0,0,0,0,51
1116350,68,3,5,0,0,0,0,76
1116351,29,0,3,0,0,0,0,32
1116352,42,8,3,0,0,0,0,53
1116353,30,9,0,0,0,0,0,39
1116354,55,5,3,0,0,0,0,63
1116355,32,3,0,0,0,0,0,35
1116356,6,3,3,0,0,0,0,12
1116357,13,0,0,0,0,0,0,13
1116358,58,0,3,0,0,0,0,61
1116359,53,6,3,0,0,0,0,62
1116360,38,3,3,0,0,0,3,47
1116361,55,3,3,0,0,0,0,61
1116362,18,0,0,0,0,0,0,18
1116363,63,7,0,6,0,0,0,76
1116364,64,3,5,0,0,0,0,72
1116365,48,0,3,0,0,0,0,51
1116366,48,5,0,0,0,0,0,53
1116367,36,8,3,0,0,0,0,47
1116401,17,3,0,0,0,0,0,20
1116402,29,5,0,0,0,0,0,34
1116403,0,0,0,0,0,0,0,0
1116404,19,0,3,0,0,0,0,22
1116405,51,9,6,0,0,0,0,66
1116406,9,0,0,0,0,0,0,9
1116407,46,11,3,0,0,0,0,60
1116408,40,7,0,3,0,0,0,50
1116409,23,3,4,0,0,0,0,30
1116410,28,8,0,0,0,0,0,36
1116411,11,5,0,0,0,0,0,16
1116412,14,0,0,0,0,0,0,14
1116413,21,3,3,3,0,0,0,30
1116414,11,3,0,0,0,0,0,14
1116415,17,7,0,0,0,0,0,24
1116416,35,3,5,0,0,0,3,46
1116417,19,3,0,0,0,0,0,22
1116418,23,4,0,0,0,0,0,27
1116419,27,6,0,3,0,0,3,39
1116420,21,0,0,0,0,0,0,21
1116421,30,0,0,0,0,0,0,30
1116422,45,6,5,0,0,0,0,56
1116423,55,3,3,4,0,0,0,65
1116424,72,10,6,0,0,0,0,88
1116425,51,3,3,0,0,0,3,60
1116426,32,0,4,3,0,0,0,39
1116427,14,4,4,0,0,0,0,22
1116428,28,0,0,0,0,0,0,28
1116429,10,0,3,0,0,0,0,13
1116430,19,0,7,4,0,0,3,33
1116431,19,0,0,0,0,0,3,22
1116432,7,3,0,0,0,0,0,10
1116433,49,7,3,0,0,0,3,62
1116434,4,0,0,0,0,0,0,4
1116435,0,0,0,0,0,0,0,0
1116436,26,3,3,0,0,0,0,32
1116437,0,0,0,0,0,0,0,0
1116438,37,8,0,0,0,0,0,45
1116501,42,0,0,0,0,0,0,42
1116502,16,5,0,0,0,0,0,21
1116503,22,0,0,3,0,0,0,25
1116504,24,3,3,0,0,0,0,30
1116505,46,9,0,0,0,0,0,55
1116506,43,5,5,0,0,0,0,53
1116507,32,4,8,0,0,0,0,44
1116508,13,3,4,0,0,0,0,20
1116509,33,3,0,3,0,0,0,39
1116510,14,4,3,0,0,0,0,21
1116511,24,0,3,0,0,0,0,27
1116512,26,4,3,3,0,0,0,36
1116513,44,4,3,0,0,0,0,51
1116514,42,0,3,0,0,0,0,45
1116515,28,3,0,0,0,0,0,31
1116516,34,4,0,0,0,0,0,38
1116601,9,3,3,0,0,0,0,15
1116602,20,4,0,0,0,0,0,24
1116603,18,3,7,0,0,0,0,28
1116604,35,5,3,3,0,0,0,46
1116605,34,4,3,0,0,0,0,41
1116606,37,0,5,0,0,0,0,42
1116607,45,3,5,0,0,0,0,53
1116608,25,3,5,0,0,0,0,33
1116609,14,4,5,3,0,0,0,26
1116610,24,3,3,0,0,4,0,34
1116611,52,3,3,4,0,0,0,62
1116612,32,7,5,0,0,0,0,44
1116613,18,0,3,0,0,0,0,21
1116614,49,0,0,0,0,0,3,52
1116615,29,3,3,3,0,0,0,38
1116616,28,0,4,0,0,0,0,32
1116617,0,0,0,0,0,0,0,0
1116618,42,3,6,0,0,0,3,54
1116619,70,5,3,0,0,0,0,78
1116620,54,3,3,0,0,0,0,60
1116621,38,0,0,0,0,0,3,41
1116622,47,6,0,0,0,0,0,53
1116623,29,0,0,0,0,0,0,29
1116624,28,7,0,0,0,0,0,35
1116625,13,3,0,0,0,0,0,16
1116626,29,4,0,0,0,0,0,33
1116627,47,0,0,0,0,0,0,47
1116628,14,3,0,0,0,0,0,17
1116629,29,0,3,0,0,0,3,35
1116701,22,0,3,0,0,0,0,25
1116702,26,3,3,0,0,0,0,32
1116703,17,0,7,0,0,0,0,24
1116704,15,0,4,0,0,0,0,19
1116705,16,0,0,0,0,0,0,16
1116706,21,0,0,0,0,0,0,21
1116707,0,0,0,0,0,0,0,0
1116708,64,3,3,0,0,0,0,70
1116709,18,0,3,0,0,0,0,21
1116710,27,0,3,0,0,0,0,30
1116711,33,0,0,0,0,0,4,37
1116712,17,3,0,0,0,0,3,23
1116713,48,3,0,5,0,0,0,56
1116714,36,0,0,0,0,0,3,39
1116715,31,4,4,0,0,0,3,42
1116801,44,4,4,0,0,0,0,52
1116802,14,0,0,0,0,0,0,14
1116803,50,0,0,0,0,0,0,50
1116804,32,3,3,3,0,0,0,41
1116805,32,3,7,0,0,3,0,45
1116806,60,5,6,0,3,0,0,74
1116807,17,3,3,0,0,0,0,23
1116808,31,7,5,0,0,0,0,43
1116809,16,5,0,0,0,0,0,21
1116810,3,0,0,0,0,0,0,3
1116811,22,0,0,0,0,0,0,22
1116812,44,5,4,0,0,0,0,53
1116813,41,9,3,0,0,0,0,53
1116814,13,3,0,0,0,0,3,19
1116815,61,6,6,0,0,0,0,73
1116816,44,5,0,0,0,0,0,49
1116817,12,3,3,0,0,0,0,18
1116818,17,0,4,0,0,0,0,21
1116819,27,4,5,0,0,0,0,36
1116820,23,0,0,3,0,0,0,26
1116821,12,0,0,0,0,0,0,12
1116822,25,3,3,0,0,0,0,31
1116823,16,6,3,0,0,0,0,25
1116824,36,0,0,0,0,0,0,36
1116825,44,3,0,0,0,0,0,47
1116826,20,0,0,0,0,0,0,20
1116827,8,3,3,0,0,3,0,17
1116828,0,0,0,0,0,0,0,0
1116829,35,0,3,0,0,0,0,38
1116901,35,3,4,0,0,0,0,42
1116902,22,0,4,0,0,0,0,26
1116903,18,0,3,0,0,0,0,21
1116904,33,5,0,0,0,0,0,38
1116905,30,4,3,3,0,0,0,40
1116906,4,0,4,4,0,0,0,12
1116907,48,0,0,0,0,0,0,48
1116908,27,3,3,0,0,0,0,33
1116909,32,0,4,0,0,0,0,36
1116910,24,6,0,0,0,0,3,33
1116911,32,3,0,0,0,0,0,35
1116912,30,4,3,3,0,0,0,40
1116913,28,8,0,0,0,0,0,36
1116914,20,0,0,0,0,0,0,20
1116915,58,4,3,0,0,0,0,65
1116916,43,7,6,3,0,0,0,59
1116917,11,4,3,0,0,0,0,18
1116918,54,4,0,0,0,0,0,58
1116919,32,3,0,0,0,0,3,38
1116920,18,3,3,3,0,0,0,27
1116921,18,0,0,0,0,0,0,18
1116922,33,3,6,3,0,0,0,45
1116923,17,3,3,0,0,0,0,23
1116924,23,4,0,0,0,0,0,27
1116925,13,0,0,0,0,0,0,13
1116926,28,4,3,0,0,0,3,38
1116927,6,0,3,0,0,0,0,9
1116928,12,5,0,0,0,0,0,17
1116929,21,0,3,0,0,0,0,24
1116930,17,3,4,0,0,0,0,24
1116931,21,3,4,0,0,0,0,28
1116932,12,5,0,0,0,0,0,17
1116933,27,0,0,4,0,0,0,31
1116934,19,0,3,3,0,0,0,25
1116935,26,4,4,0,0,0,0,34
1116936,10,0,4,0,0,0,0,14
1116937,39,0,3,0,0,0,0,42
1116938,19,3,0,0,0,0,0,22
1116939,26,0,4,0,0,0,0,30
1116940,9,3,0,0,0,0,0,12
1116941,10,0,0,0,0,0,0,10
1116942,12,5,4,0,0,0,0,21
1116943,34,6,9,0,0,0,0,49
1116944,12,0,4,4,0,0,0,20
1116945,12,4,0,0,0,0,0,16
1116946,20,6,0,3,0,0,0,29
1116947,3,3,5,0,0,0,0,11
1116948,35,4,3,0,0,0,0,42
1116949,51,4,8,3,0,0,0,66
1116950,30,0,4,0,0,0,0,34
1116951,9,0,0,0,0,0,0,9
1116952,8,0,0,0,0,0,3,11
1116953,12,0,0,0,0,0,0,12
1116954,35,5,3,0,0,0,3,46
1116955,31,4,0,0,0,0,0,35
1116956,38,4,0,0,0,0,0,42
1116957,24,3,5,0,0,0,0,32
1116958,24,0,4,3,0,0,0,31
1116959,25,3,0,0,0,0,0,28
1116960,18,0,0,0,0,0,0,18
1117001,49,6,0,4,0,0,0,59
1117002,0,0,0,0,0,0,0,0
1117003,16,3,3,0,0,0,0,22
1117004,27,3,0,0,0,0,0,30
1117005,15,0,0,0,0,0,0,15
1117006,18,0,3,0,0,0,3,24
1117007,8,0,0,0,0,0,3,11
1117008,24,3,3,0,0,0,0,30
1117009,0,0,0,0,0,0,0,0
1117010,27,0,3,0,0,0,0,30
1117011,0,0,0,0,0,0,0,0
1117012,40,0,0,0,0,0,0,40
1117013,28,5,0,0,0,0,0,33
1117014,33,0,0,0,0,0,5,38
1117015,37,11,3,0,0,0,3,54
1117016,26,3,3,0,0,0,3,35
1117017,30,3,4,3,0,0,0,40
1117018,0,0,0,0,0,0,0,0
1117019,19,3,4,0,0,0,3,29
1117020,30,0,0,3,0,0,0,33
1117021,34,3,3,0,0,0,3,43
1117022,30,0,0,0,0,0,0,30
1117023,27,3,4,0,0,0,0,34
1117024,18,3,3,4,0,0,0,28
1117025,24,3,0,3,0,0,0,30
1117026,19,0,3,0,0,0,0,22
1117027,32,4,4,0,0,0,0,40
1117028,25,5,0,0,0,0,0,30
1117029,10,0,0,0,0,0,0,10
1117030,13,0,0,0,0,0,0,13
1117031,29,3,3,0,0,0,0,35
1117032,45,5,0,0,0,0,0,50
1117033,27,3,3,0,0,0,0,33
1117034,31,6,3,0,0,0,0,40
1117035,0,0,0,0,0,0,0,0
1117036,8,0,0,0,0,0,0,8
1117037,15,3,0,0,0,0,0,18
1117038,14,0,4,0,0,0,0,18
1117039,19,3,4,0,0,3,0,29
1117101,18,3,4,0,0,0,0,25
1117102,34,0,4,0,0,0,0,38
1117103,28,3,0,0,0,0,0,31
1117104,28,3,3,0,0,0,0,34
1117105,38,3,3,0,0,0,0,44
1117106,45,0,3,4,0,0,0,52
1117107,44,3,3,0,0,0,0,50
1117108,44,6,0,0,0,0,0,50
1117109,29,3,3,3,0,0,0,38
1117110,28,0,0,0,0,0,0,28
1117111,29,3,3,0,0,0,0,35
1117112,9,0,4,3,0,0,0,16
1117113,26,3,0,0,0,0,0,29
1117114,13,0,0,0,0,0,0,13
1117115,12,0,0,0,0,3,0,15
1117201,50,0,5,0,0,0,0,55
1117202,68,4,0,3,0,0,0,75
1117203,47,8,0,0,0,0,0,55
1117204,37,5,0,0,0,0,0,42
1117205,53,0,0,0,0,0,5,58
1117206,101,5,6,0,0,0,0,112
1117207,28,4,3,0,0,0,0,35
1117208,68,4,3,0,0,0,0,75
1117209,42,3,0,0,0,0,0,45
1117210,54,5,0,0,0,0,0,59
1117211,52,3,0,0,0,0,0,55
1117212,25,6,3,0,0,0,0,34
1117213,35,3,3,0,0,0,0,41
1117214,41,3,3,0,0,0,0,47
1117215,23,3,0,0,0,0,3,29
1117216,28,3,3,3,0,0,0,37
1117217,56,5,3,0,0,0,0,64
1117218,27,3,0,0,0,0,0,30
1117219,17,0,0,0,0,0,0,17
1117220,75,8,3,3,0,0,0,89
1117221,79,11,5,0,0,0,0,95
1117222,29,8,3,0,0,0,0,40
1117223,102,8,13,0,0,0,0,123
1117224,19,3,0,0,0,0,3,25
1117225,16,0,0,0,0,0,0,16
1117226,32,3,0,0,0,0,0,35
1117227,92,3,3,0,0,0,0,98
1117228,45,0,4,0,0,0,0,49
1117229,43,4,3,0,0,0,0,50
1117230,0,0,0,0,0,0,0,0
1117301,16,4,0,0,0,0,0,20
1117302,39,4,0,0,0,0,0,43
1117303,24,3,0,0,0,0,0,27
1117304,11,4,3,0,0,0,0,18
1117305,40,0,3,0,0,0,0,43
1117306,39,4,8,0,0,0,0,51
1117307,40,5,7,0,0,0,0,52
1117308,11,0,3,0,0,0,0,14
1117309,48,4,0,0,0,0,3,55
1117310,12,3,0,0,0,0,0,15
1117311,52,3,0,0,0,0,0,55
1117312,32,5,0,0,0,0,0,37
1117313,13,3,0,0,0,3,0,19
1117314,28,6,0,0,0,0,0,34
1117315,26,0,4,0,0,0,0,30
1117316,37,0,0,0,0,0,0,37
1117317,37,3,0,0,0,0,0,40
1117318,40,3,0,0,0,0,0,43
1117319,21,0,3,0,0,0,0,24
1117320,24,6,3,0,0,0,0,33
1117321,61,7,0,0,0,0,0,68
1117322,60,0,0,0,0,0,0,60
1117323,12,0,0,0,0,0,0,12
1117324,27,3,3,3,0,0,0,36
1117325,42,4,0,0,0,0,0,46
1117326,38,0,4,0,0,0,0,42
1117401,14,3,3,0,0,0,0,20
1117402,33,0,3,0,0,0,0,36
1117403,47,7,3,0,0,0,0,57
1117404,23,3,3,0,0,0,0,29
1117405,52,7,3,0,0,0,0,62
1117406,38,5,3,3,0,0,3,52
1117407,26,3,3,0,0,0,0,32
1117408,33,5,0,0,0,0,0,38
1117409,25,0,3,0,0,0,0,28
1117410,27,4,8,0,0,0,4,43
1117411,32,0,4,0,0,0,0,36
1117412,12,3,0,0,0,0,0,15
1117413,31,3,0,0,0,0,0,34
1117414,13,3,3,0,0,0,0,19
1117415,67,0,0,0,0,0,0,67
1117416,42,3,0,3,0,0,0,48
1117417,39,0,3,0,0,0,0,42
1117418,67,5,0,0,0,0,0,72
1117419,0,0,0,0,0,0,0,0
1117420,0,0,0,0,0,0,0,0
1117421,0,0,0,0,0,0,0,0
1117422,0,0,0,0,0,0,0,0
1117423,14,3,0,0,0,0,0,17
1117424,22,0,0,0,0,0,0,22
1117425,32,3,3,0,0,0,0,38
1117426,31,4,0,0,0,0,0,35
1117427,3,0,0,0,0,0,0,3
1117428,31,0,0,0,0,0,0,31
1117429,38,4,0,0,0,0,0,42
1117501,54,3,3,0,0,0,0,60
1117502,26,4,4,0,0,0,0,34
1117503,45,3,3,0,0,0,3,54
1117504,60,3,0,0,0,0,0,63
1117505,30,4,4,0,0,0,0,38
1117506,50,3,9,0,0,0,0,62
1117507,63,3,3,0,0,0,0,69
1117508,78,5,0,3,0,0,0,86
1117509,32,0,3,0,0,0,0,35
1117510,18,0,3,0,0,0,0,21
1117511,34,4,3,0,0,0,0,41
1117512,37,4,0,0,0,0,0,41
1117513,46,3,6,0,0,0,0,55
1117514,51,4,0,0,0,0,0,55
1117515,27,0,3,0,0,0,0,30
1117516,43,0,3,0,0,0,0,46
1117517,43,7,0,0,0,0,0,50
1117518,28,3,0,0,0,0,0,31
1117519,23,0,0,3,0,0,0,26
1117520,28,0,0,0,0,0,0,28
1117521,23,0,3,0,0,0,0,26
1117522,27,4,6,0,0,0,3,40
1117523,33,3,0,0,0,0,0,36
1117524,23,0,3,0,0,0,3,29
1117525,37,0,0,0,0,0,0,37
1117526,31,0,0,0,0,0,0,31
1117527,36,0,3,0,0,0,0,39
1117528,30,0,3,0,0,0,4,37
1117529,37,0,7,0,0,0,0,44
1117530,0,0,0,0,0,0,0,0
1117531,47,0,3,0,0,0,0,50
1117532,27,0,0,0,0,0,0,27
1117533,26,0,3,0,0,0,0,29
1117534,6,0,0,0,0,0,0,6
1117601,24,4,3,0,0,0,0,31
1117602,25,3,3,0,0,0,0,31
1117603,28,4,0,0,0,0,0,32
1117604,53,3,5,0,0,0,0,61
1117605,37,3,3,0,0,0,0,43
1117606,26,0,5,0,0,0,0,31
1117607,54,9,0,0,0,0,0,63
1117608,18,0,3,0,0,0,3,24
1117609,24,4,0,0,0,0,0,28
1117610,43,5,5,0,0,0,0,53
1117611,22,0,0,0,0,0,0,22
1117612,20,0,3,0,0,0,0,23
1117613,35,5,3,0,0,0,0,43
1117614,19,3,3,0,0,0,0,25
1117615,48,4,3,0,0,0,3,58
1117616,21,0,3,0,0,0,6,30
1117617,31,6,0,0,0,0,0,37
1117618,28,0,3,0,0,0,0,31
1117619,28,0,0,0,0,0,0,28
1117620,31,0,5,0,0,0,0,36
1117621,19,5,0,0,0,0,0,24
1117622,29,3,3,0,0,0,0,35
1117623,27,0,4,0,0,0,0,31
1117624,28,3,3,0,0,0,0,34
1117625,17,0,0,0,0,0,0,17
1117626,0,0,0,0,0,0,0,0
1117627,31,0,3,0,0,0,0,34
1117628,54,3,4,0,0,0,0,61
1117629,7,0,0,0,0,0,0,7
1117630,10,0,0,0,0,0,0,10
1117631,28,5,5,0,0,0,0,38
1117632,29,5,4,0,0,0,0,38
1117633,67,7,7,0,0,0,0,81
1117634,63,5,7,0,0,0,3,78
1117635,17,0,3,0,0,0,0,20
1117636,47,6,3,0,0,0,0,56
1117701,31,5,0,0,0,0,0,36
1117702,16,4,3,0,0,0,0,23
1117703,14,0,3,0,0,0,0,17
1117704,30,3,0,0,0,3,0,36
1117705,20,3,3,0,0,0,0,26
1117706,13,0,0,0,0,0,0,13
1117707,23,0,3,0,0,0,0,26
1117708,25,0,0,0,0,0,4,29
1117709,15,0,0,0,0,0,0,15
1117710,19,0,0,0,0,0,0,19
1117711,28,3,0,0,0,0,0,31
1117712,42,3,0,0,0,0,0,45
1117801,45,3,3,0,0,0,0,51
1117802,42,4,6,0,0,0,3,55
1117803,20,0,0,5,0,0,0,25
1117804,35,4,0,0,0,0,0,39
1117805,40,0,4,0,0,0,0,44
1117806,0,0,0,0,0,0,0,0
1117807,10,0,3,3,0,0,3,19
1117808,26,0,3,4,0,0,0,33
1117809,24,4,4,0,0,0,0,32
1117810,6,3,0,3,0,0,3,15
1117811,16,3,3,0,0,0,3,25
1117812,16,3,0,3,0,0,3,25
1117813,22,0,3,0,0,0,0,25
1117814,18,0,3,0,0,0,0,21
1117815,13,3,7,0,0,0,0,23
1117816,0,0,0,0,0,0,0,0
1117817,40,3,3,0,0,0,0,46
1117818,26,0,0,0,0,0,3,29
1117819,26,3,3,0,0,0,0,32
1117820,30,0,0,0,0,0,0,30
1117821,42,4,0,0,0,0,0,46
1117822,26,0,3,0,0,0,0,29
1117901,46,3,3,0,0,0,0,52
1117902,13,0,3,0,0,0,0,16
1117903,40,6,5,0,0,0,0,51
1117904,32,0,0,0,0,0,0,32
1117905,25,3,0,0,0,0,0,28
1117906,29,0,3,0,0,0,0,32
1117907,58,0,0,0,0,0,0,58
1117908,38,3,0,0,0,0,0,41
1117909,29,0,3,0,0,0,0,32
1117910,36,3,0,0,0,3,0,42
1117911,8,0,0,0,0,0,0,8
1118001,17,0,0,0,0,0,0,17
1118002,13,0,5,0,0,0,0,18
1118003,42,0,5,0,0,0,0,47
1118004,21,0,3,3,0,0,3,30
1118005,17,0,4,0,0,0,0,21
1118006,23,3,3,0,0,0,0,29
1118007,39,0,0,0,0,0,0,39
1118008,18,3,0,0,0,0,0,21
1118009,7,0,0,0,0,0,0,7
1118010,17,0,0,0,0,0,0,17
1118011,38,0,3,0,0,0,0,41
1118012,44,4,5,0,0,0,0,53
1118013,51,8,7,0,0,0,0,66
1118014,3,0,0,0,0,0,0,3
1118015,0,0,0,0,0,0,0,0
1118016,0,0,0,0,0,0,0,0
1118017,20,0,0,0,0,0,0,20
1118018,17,3,3,0,0,0,0,23
1118019,7,0,0,0,0,0,0,7
1118020,33,4,4,0,0,0,0,41
1118021,17,3,3,0,0,0,0,23
1118101,28,0,4,0,0,0,0,32
1118102,37,3,0,0,0,0,0,40
1118103,30,0,0,0,0,0,0,30
1118104,36,3,3,0,0,0,0,42
1118105,19,4,3,0,0,0,0,26
1118106,39,4,4,0,0,0,0,47
1118107,0,0,0,0,0,0,0,0
1118108,25,3,3,0,0,0,3,34
1118109,32,4,3,0,0,0,0,39
1118110,19,0,4,0,0,0,0,23
1118111,47,5,0,0,0,0,0,52
1118112,19,0,0,0,0,0,0,19
1118113,21,0,3,0,0,0,0,24
1118114,40,3,3,3,0,0,0,49
1118115,37,5,4,0,0,0,0,46
1118116,42,8,4,0,0,0,0,54
1118117,20,3,3,0,0,0,0,26
1118118,26,0,0,0,0,0,0,26
1118119,18,3,0,3,0,0,0,24
1118120,29,0,0,0,0,0,0,29
1118201,15,3,0,0,0,0,0,18
1118202,0,0,0,0,0,0,0,0
1118203,15,3,4,0,0,0,0,22
1118204,33,3,3,0,0,0,0,39
1118205,22,0,3,0,0,0,3,28
1118206,20,4,0,0,0,0,0,24
1118207,33,0,0,0,0,0,0,33
1118208,15,3,3,0,0,3,0,24
1118209,38,3,3,0,0,0,0,44
1118210,16,0,3,0,0,0,0,19
1118211,31,0,4,0,0,0,0,35
1118212,21,0,3,0,0,0,0,24
1118213,34,0,4,0,0,0,0,38
1118214,28,0,4,0,0,0,0,32
1118215,24,3,0,0,0,0,0,27
1118216,12,0,3,0,0,0,0,15
1118217,21,3,3,0,0,0,0,27
1118218,22,0,4,0,0,0,0,26
1118219,30,3,4,0,0,0,0,37
1118220,34,5,0,0,0,0,0,39
1118221,18,3,0,0,0,0,0,21
1118222,34,3,5,0,0,0,0,42
1118223,0,0,0,0,0,0,0,0
1118224,47,4,0,0,0,0,0,51
1118301,30,0,3,0,0,0,0,33
1118302,20,0,4,0,0,0,0,24
1118303,10,0,4,0,0,0,0,14
1118304,18,0,0,0,0,0,3,21
1118305,39,0,3,0,0,0,0,42
1118306,19,4,0,0,0,0,0,23
1118307,11,3,0,0,0,0,0,14
1118308,20,4,4,0,0,0,4,32
1118309,28,3,0,0,0,0,0,31
1118310,29,4,0,0,0,0,0,33
1118311,26,0,0,0,0,0,0,26
1118312,47,3,3,3,0,0,0,56
1118313,35,5,0,0,0,0,0,40
1118314,27,0,0,0,0,0,0,27
1118315,41,4,4,0,0,0,3,52
1118316,46,6,3,0,0,0,3,58
1118317,45,7,0,4,0,3,0,59
1118318,46,3,0,0,0,0,0,49
1118319,50,0,5,0,0,0,0,55
1118320,35,0,0,0,0,0,0,35
1118321,17,0,0,0,0,0,0,17
1118322,9,0,0,0,0,0,0,9
1118401,20,4,0,0,0,0,0,24
1118402,24,0,3,0,0,0,0,27
1118403,48,4,3,0,0,3,0,58
1118404,15,3,0,0,0,0,4,22
1118405,4,0,0,0,0,0,0,4
1118406,3,0,0,0,0,0,0,3
1118407,29,3,3,0,0,0,0,35
1118408,19,3,3,0,0,0,0,25
1118409,20,0,0,0,0,0,0,20
1118410,32,3,0,0,0,0,0,35
1118411,54,5,3,3,0,0,0,65
1118412,50,0,4,0,0,0,0,54
1118413,38,0,0,0,0,0,0,38
1118414,24,3,0,0,0,0,0,27
1118415,28,3,3,0,0,0,0,34
1118501,19,3,4,0,0,0,0,26
1118502,45,3,5,0,0,0,0,53
1118503,32,4,0,0,0,0,0,36
1118504,24,4,3,0,0,0,0,31
1118505,34,0,4,0,0,0,0,38
1118506,30,0,0,3,0,0,0,33
1118507,24,0,3,0,0,0,0,27
1118508,31,0,0,0,0,0,0,31
1118509,39,0,0,0,0,0,0,39
1118510,33,0,3,0,0,0,0,36
1118511,24,0,0,0,0,0,0,24
1118512,52,3,0,0,0,0,0,55
1118513,37,3,0,0,0,0,0,40
1118514,19,0,3,0,0,0,0,22
1118515,17,3,3,0,0,0,0,23
1118516,20,3,3,0,0,3,0,29
1118517,36,5,0,0,0,0,3,44
1118518,22,0,0,0,0,0,0,22
1118519,25,0,3,0,0,0,0,28
1118520,18,0,3,0,0,0,0,21
1118521,24,0,3,0,0,0,3,30
1118522,18,0,0,0,0,0,0,18
1118523,27,4,0,0,0,0,0,31
1118524,27,3,5,0,0,0,0,35
1118525,27,0,6,0,0,0,0,33
1118526,13,3,3,0,0,0,0,19
1118527,42,3,5,0,0,0,3,53
1118601,0,0,0,0,0,0,0,0
1118602,57,6,0,0,0,0,0,63
1118603,58,5,3,0,0,0,0,66
1118604,87,4,0,0,0,0,0,91
1118605,59,3,3,0,0,0,0,65
1118606,45,0,0,0,0,0,0,45
1118607,12,0,5,0,0,0,0,17
1118608,28,3,0,3,0,0,0,34
1118609,41,4,3,0,0,0,0,48
1118610,16,4,3,3,0,0,0,26
1118611,32,0,0,3,0,0,0,35
1118612,55,0,0,0,0,0,0,55
1118613,23,3,0,0,0,0,0,26
1118614,32,3,5,0,0,0,0,40
1118615,63,3,3,0,0,0,0,69
1118616,32,3,0,0,0,0,0,35
1118617,25,4,0,4,0,0,0,33
1118618,46,3,0,0,0,0,0,49
1118619,15,0,3,0,0,0,0,18
1118620,29,3,3,3,0,0,0,38
1118621,29,3,0,0,0,0,0,32
1118622,44,3,0,0,0,0,0,47
1118623,46,3,3,0,0,0,0,52
1118624,64,3,4,0,0,0,0,71
1118625,17,0,0,0,0,0,0,17
1118626,23,8,0,0,0,0,0,31
1118627,38,7,0,0,0,0,0,45
1118628,33,0,4,0,0,0,0,37
1118629,51,3,0,0,0,0,0,54
1118630,26,5,0,0,0,0,0,31
1118631,15,0,0,0,0,0,0,15
1118632,33,3,0,0,0,3,0,39
1118633,18,0,0,0,0,0,0,18
1118634,18,0,0,0,0,0,0,18
1118635,12,0,0,0,0,0,0,12
1118636,25,0,0,0,3,0,0,28
1118637,48,3,3,0,0,0,0,54
1118638,35,3,3,0,0,0,0,41
1118639,23,0,0,0,0,5,0,28
1118640,28,0,3,3,0,0,0,34
1118641,38,8,3,0,0,0,0,49
1118642,25,5,3,0,0,0,3,36
1118643,29,0,0,0,0,0,0,29
1118644,26,4,5,0,0,0,0,35
1118645,25,3,0,0,0,0,0,28
1118646,15,0,0,0,0,0,0,15
1118647,29,8,0,4,0,0,0,41
1118648,29,5,0,0,0,0,0,34
1118649,35,7,4,0,0,0,0,46
1118650,40,0,0,0,0,0,0,40
1118651,53,4,0,0,0,0,0,57
1118652,33,3,4,0,0,0,0,40
1118653,18,0,3,0,0,0,0,21
1118654,47,4,3,0,0,0,0,54
1118701,44,0,3,4,0,0,0,51
1118702,31,6,4,0,0,0,0,41
1118703,33,0,3,3,0,0,0,39
1118704,40,3,3,3,0,0,0,49
1118705,14,0,0,0,0,0,0,14
1118706,38,5,3,0,3,0,0,49
1118707,49,3,0,0,0,0,3,55
1118708,46,0,3,3,0,0,0,52
1118709,25,4,0,0,0,0,0,29
1118710,32,3,0,0,0,0,0,35
1118711,29,4,0,0,0,0,0,33
1118712,32,4,0,0,0,0,0,36
1118801,40,0,6,0,0,0,0,46
1118802,39,3,0,0,0,0,0,42
1118803,38,4,0,0,0,0,0,42
1118804,20,0,0,0,0,0,0,20
1118805,55,6,3,0,0,0,0,64
1118806,53,3,0,3,0,0,0,59
1118807,37,3,6,0,0,0,3,49
1118808,34,5,0,0,0,0,0,39
1118809,18,3,0,0,0,0,3,24
1118810,58,0,0,4,0,0,0,62
1118811,19,0,0,0,0,0,0,19
1118812,22,5,3,0,0,0,0,30
1118813,20,0,0,3,0,0,0,23
1118814,34,3,3,0,0,0,0,40
1118815,26,7,0,0,0,0,0,33
1118816,24,0,3,0,0,0,0,27
1118817,34,0,4,0,0,0,0,38
1118818,31,3,0,0,0,0,0,34
1118819,17,0,0,0,0,0,0,17
1118901,13,3,0,0,0,0,0,16
1118902,22,4,0,0,0,0,3,29
1118903,23,3,3,0,0,0,0,29
1118904,19,0,3,0,0,0,0,22
1118905,31,3,3,0,0,0,0,37
1118906,31,0,0,0,0,0,0,31
1118907,40,5,0,0,0,0,0,45
1118908,44,0,4,0,0,0,0,48
1118909,13,0,0,0,0,0,0,13
1118910,13,0,0,0,0,0,0,13
1118911,33,0,3,0,0,0,0,36
1118912,16,0,3,0,0,0,0,19
1119001,29,0,0,0,0,0,0,29
1119002,41,3,3,0,0,0,3,50
1119003,19,3,0,0,0,0,0,22
1119004,18,4,3,0,0,0,0,25
1119005,29,3,0,0,0,0,0,32
1119006,17,3,3,0,0,0,0,23
1119007,12,7,3,0,0,0,0,22
1119008,26,4,3,0,0,0,0,33
1119009,29,3,5,0,0,0,0,37
1119010,28,4,0,0,0,0,0,32
1119011,26,3,0,0,0,0,0,29
1119012,28,0,0,0,0,0,0,28
1119013,36,3,0,3,0,0,0,42
1119014,25,0,0,0,0,0,0,25
1119015,23,4,3,0,0,0,0,30
1119016,16,3,3,0,0,0,0,22
1119017,26,0,0,0,0,3,0,29
1119018,36,5,0,0,0,0,0,41
1119019,13,0,3,0,0,0,0,16
1119020,22,0,0,0,0,0,0,22
1119021,46,6,0,0,0,0,0,52
1119022,40,4,0,0,0,0,0,44
1119023,20,7,0,0,0,0,0,27
1119024,18,3,0,0,0,0,3,24
1119025,22,3,0,0,0,0,0,25
1119101,37,0,0,0,0,4,0,41
1119102,51,0,0,0,0,0,0,51
1119103,35,4,4,0,0,0,0,43
1119104,18,3,0,0,0,0,0,21
1119105,30,0,0,0,0,0,0,30
1119106,41,3,0,0,0,0,0,44
1119107,29,0,5,0,0,0,0,34
1119108,27,9,0,0,0,0,0,36
1119109,23,0,0,0,0,0,3,26
1119110,31,0,3,3,0,0,0,37
1119111,51,3,7,0,0,0,0,61
1119112,23,9,4,0,0,0,0,36
1119113,50,5,3,0,0,0,0,58
1119114,45,3,6,3,0,0,0,57
1119115,6,0,0,0,0,0,0,6
1119116,13,4,0,0,0,0,0,17
1119117,54,6,4,0,0,0,0,64
1119118,29,4,3,0,0,0,0,36
1119119,40,3,7,0,0,0,0,50
1119120,54,3,3,0,0,0,0,60
1119121,36,3,0,0,0,0,0,39
1119122,49,7,3,0,0,0,0,59
1119123,29,3,3,0,0,0,0,35
1119124,34,10,0,0,0,0,0,44
1119125,49,6,8,0,0,0,0,63
1119126,16,5,0,0,0,0,0,21
1119127,38,3,3,0,0,0,0,44
1119128,9,5,5,0,0,0,0,19
1119201,16,4,0,0,0,0,0,20
1119202,15,0,0,0,0,0,0,15
1119203,19,3,0,3,0,0,0,25
1119204,10,3,3,3,0,0,0,19
1119205,33,0,0,0,0,0,3,36
1119206,24,6,4,0,0,0,0,34
1119207,36,3,4,0,0,0,4,47
1119208,37,0,4,0,0,0,0,41
1119209,16,3,3,3,0,3,0,28
1119210,38,3,3,3,0,0,0,47
1119211,45,3,3,0,0,0,0,51
1119212,54,4,5,0,0,0,4,67
1119213,29,3,0,0,0,0,3,35
1119214,27,0,0,0,0,0,0,27
1119215,68,3,5,3,0,0,0,79
1119301,16,0,0,0,0,0,0,16
1119302,41,0,0,0,0,0,0,41
1119303,28,3,0,0,0,0,0,31
1119304,34,3,0,0,0,0,3,40
1119305,9,0,0,4,0,0,0,13
1119306,32,0,3,0,0,0,0,35
1119307,36,3,8,0,0,0,0,47
1119308,36,3,0,0,0,0,0,39
1119309,35,3,3,0,0,0,0,41
1119310,39,4,0,0,0,0,0,43
1119311,18,4,0,0,0,0,0,22
1119312,25,3,0,0,0,0,0,28
1119313,24,0,3,0,0,0,0,27
1119314,22,5,3,0,0,0,0,30
1119315,34,3,0,0,0,0,0,37
1119316,30,9,5,0,0,0,0,44
1119317,19,0,6,0,0,0,0,25
1119318,13,4,0,0,0,0,0,17
1119319,20,3,3,3,0,0,0,29
1119320,15,0,3,0,0,0,0,18
1119401,11,4,0,0,0,0,0,15
1119402,18,8,0,0,0,0,0,26
1119403,38,0,0,0,0,0,0,38
1119404,21,4,0,0,0,0,0,25
1119405,16,3,0,0,0,0,0,19
1119406,15,3,3,0,0,0,0,21
1119407,25,4,3,0,0,0,0,32
1119408,35,3,7,0,0,0,0,45
1119409,19,3,0,0,0,0,0,22
1119410,8,0,4,0,0,0,0,12
1119411,17,0,3,0,0,0,0,20
1119412,29,0,0,0,0,0,0,29
1119413,12,0,4,0,0,0,0,16
1119414,31,0,4,0,0,0,0,35
1119415,12,0,5,0,0,0,0,17
1119416,12,0,3,0,0,0,0,15
1119417,21,0,0,0,0,0,0,21
1119418,47,0,0,0,0,0,0,47
1119419,36,0,0,0,0,0,0,36
1119420,12,4,0,0,0,0,0,16
1119421,3,3,0,0,0,0,0,6
1119422,28,0,0,0,0,0,0,28
1119423,12,3,5,0,0,0,0,20
1119424,16,0,0,0,0,0,0,16
1119501,0,0,0,0,0,0,0,0
1119502,19,0,0,0,0,0,0,19
1119503,14,0,3,0,0,0,3,20
1119504,50,0,0,0,0,0,0,50
1119505,40,3,3,0,0,0,0,46
1119506,25,3,0,3,0,0,0,31
1119507,29,0,3,0,0,0,0,32
1119508,30,4,0,0,0,0,0,34
1119509,20,0,0,0,0,0,0,20
1119510,65,3,3,0,0,0,0,71
1119511,38,3,3,0,0,0,0,44
1119512,6,0,0,0,0,0,0,6
1119513,41,3,3,0,0,0,0,47
1119514,30,5,3,3,0,0,0,41
1119515,22,3,5,0,0,0,3,33
1119516,34,3,9,0,0,0,0,46
1119517,22,3,4,0,0,0,0,29
1119518,17,4,3,4,0,0,0,28
1119519,32,5,0,0,0,0,0,37
1119520,23,4,0,0,0,0,0,27
1119521,10,3,0,0,0,3,3,19
1119522,47,0,0,0,0,0,0,47
1119523,39,0,6,0,0,0,0,45
1119524,0,0,0,0,0,0,0,0
1119525,0,0,0,0,0,0,0,0
1119601,16,0,4,0,0,0,0,20
1119602,16,3,0,0,0,0,0,19
1119603,21,0,0,0,0,0,0,21
1119604,43,4,0,0,0,0,0,47
1119605,58,3,4,0,0,0,0,65
1119606,49,0,4,0,0,0,0,53
1119607,15,0,0,4,0,0,4,23
1119608,23,4,10,0,3,0,0,40
1119609,12,3,3,0,0,0,0,18
1119610,15,0,0,0,0,0,0,15
1119611,24,0,3,0,0,0,0,27
1119612,46,3,6,0,0,0,0,55
1119613,28,3,0,0,0,0,0,31
1119614,28,3,5,3,0,0,0,39
1119615,32,0,0,0,0,0,0,32
1119616,36,3,3,0,0,0,0,42
1119617,30,3,3,0,0,0,0,36
1119618,76,4,5,0,0,0,0,85
1119701,21,0,0,0,0,0,0,21
1119702,19,0,3,0,0,0,0,22
1119703,30,3,0,0,0,0,0,33
1119704,22,0,0,0,0,0,3,25
1119705,44,5,0,4,0,0,0,53
1119706,24,3,3,0,0,0,0,30
1119707,26,0,0,0,0,0,0,26
1119708,29,3,3,3,0,0,0,38
1119709,41,0,0,0,0,0,0,41
1119710,27,3,4,0,0,0,3,37
1119711,30,3,4,0,0,0,0,37
1119712,27,3,3,0,0,0,4,37
1119713,29,3,3,0,0,0,0,35
1119714,27,0,3,0,0,0,0,30
1119715,36,3,3,0,0,0,0,42
1119716,0,0,0,0,0,0,0,0
1119717,26,0,3,0,0,0,0,29
1119718,16,0,7,0,0,0,0,23
1119719,19,3,3,3,0,0,0,28
1119720,20,0,0,0,0,0,0,20
1119721,80,0,5,3,0,0,0,88
1119722,48,0,3,0,0,0,0,51
1119801,41,0,3,3,0,0,0,47
1119802,20,3,0,0,0,0,0,23
1119803,55,3,0,0,0,0,0,58
1119804,52,0,0,0,0,0,0,52
1119805,26,3,3,0,0,0,0,32
1119806,29,0,5,0,0,0,0,34
1119807,19,3,0,0,0,0,0,22
1119808,54,0,3,0,0,0,0,57
1119809,41,0,0,0,0,0,0,41
1119810,12,3,4,0,0,0,0,19
1119811,35,3,3,3,0,3,0,47
1119812,30,0,4,0,0,0,0,34
1119813,56,3,3,3,0,0,0,65
1119814,28,6,0,0,0,0,0,34
1119901,36,5,9,0,0,0,3,53
1119902,30,3,3,0,0,0,0,36
1119903,35,3,3,0,0,0,0,41
1119904,27,3,3,0,0,0,0,33
1119905,42,3,0,0,0,0,0,45
1119906,33,5,3,0,0,0,0,41
1119907,48,4,4,0,0,0,0,56
1119908,35,3,0,0,0,0,3,41
1119909,15,0,3,0,0,0,0,18
1119910,22,3,3,0,0,0,0,28
1119911,24,3,3,0,0,0,0,30
1119912,67,0,6,0,0,0,0,73
1119913,30,6,4,0,0,0,0,40
1119914,21,4,0,4,0,0,0,29
1119915,75,3,4,0,0,0,3,85
1119916,43,4,6,0,0,0,0,53
1119917,21,0,0,0,0,0,0,21
1119918,43,0,3,0,0,0,0,46
1119919,37,9,0,0,0,0,0,46
1119920,27,0,0,0,0,0,0,27
1119921,49,3,3,0,0,0,3,58
1120001,52,6,0,3,0,0,3,64
1120002,34,7,3,0,0,0,0,44
1120003,29,3,3,0,0,0,3,38
1120004,18,0,0,0,0,0,0,18
1120005,28,3,0,0,0,0,0,31
1120006,49,3,0,0,0,0,0,52
1120007,39,9,0,0,0,0,0,48
1120008,28,0,4,0,0,0,0,32
1120009,31,0,0,0,0,0,0,31
1120010,47,3,3,0,0,0,0,53
1120011,28,0,0,3,0,0,0,31
1120012,53,3,3,3,0,0,0,62
1120013,42,4,0,0,0,0,0,46
1120101,40,5,7,3,0,0,0,55
1120102,7,0,0,0,0,0,3,10
1120103,24,0,3,0,0,0,0,27
1120104,21,3,3,0,0,0,0,27
1120105,38,5,0,0,0,0,0,43
1120106,31,0,10,0,0,0,0,41
1120107,11,6,0,0,0,0,0,17
1120108,21,3,0,0,0,0,0,24
1120109,21,3,3,0,0,0,0,27
1120110,26,7,0,3,0,0,0,36
1120111,21,0,3,3,0,0,0,27
1120112,23,0,0,0,0,0,3,26
1120113,25,3,4,0,0,0,0,32
1120114,26,3,3,0,0,0,0,32
1120115,55,3,3,0,0,0,0,61
1120116,54,10,3,0,0,0,0,67
1120117,31,0,0,4,0,0,0,35
1120118,34,0,0,0,0,3,0,37
1120119,32,5,0,4,0,0,0,41
1120120,20,5,0,0,0,0,0,25
1120121,38,3,0,0,0,0,0,41
1120122,3,0,0,0,0,0,0,3
1120201,77,4,0,3,0,0,0,84
1120202,31,6,0,0,0,0,0,37
1120203,53,3,4,0,0,0,0,60
1120204,87,13,5,0,0,0,0,105
1120205,70,0,4,3,0,0,0,77
1120206,29,3,3,0,0,0,0,35
1120207,72,8,3,0,0,0,0,83
1120208,39,0,3,0,0,0,0,42
1120209,76,3,0,3,0,0,0,82
1120210,25,0,0,0,0,0,0,25
1120211,0,0,0,0,0,0,0,0
1120212,43,0,3,0,0,0,0,46
1120213,41,4,0,0,0,0,0,45
1120214,62,3,7,0,0,0,0,72
1120215,26,0,3,0,0,0,0,29
1120216,29,3,0,0,0,0,0,32
1120217,25,3,3,0,0,0,0,31
1120218,20,0,3,0,0,0,0,23
1120219,27,4,0,0,0,0,0,31
1120220,49,5,7,0,0,0,0,61
1120221,14,0,0,0,0,0,0,14
1120222,29,0,0,0,0,0,0,29
1120223,64,3,3,0,0,0,0,70
1120224,9,0,0,0,0,0,0,9
1120225,29,3,3,0,0,0,0,35
1120226,24,5,0,0,0,0,0,29
1120227,25,3,3,0,0,0,0,31
1120228,17,3,0,0,0,0,0,20
1120229,0,0,0,0,0,0,0,0
1120230,23,0,3,0,0,0,0,26
1120231,28,4,3,0,0,0,3,38
1120232,20,0,0,0,0,0,0,20
1120233,7,0,0,0,0,0,0,7
1120234,31,0,4,0,0,0,0,35
1120235,28,7,7,3,0,0,0,45
1120236,9,5,3,0,0,0,0,17
1120237,26,7,0,0,0,0,0,33
1120238,9,0,5,0,0,0,0,14
1120239,29,0,0,0,0,0,0,29
1120240,37,9,0,0,0,0,0,46
1120241,27,6,0,0,0,0,0,33
1120242,21,4,3,3,0,0,0,31
1120243,39,3,3,0,0,0,3,48
1120244,37,3,3,0,0,0,0,43
1120245,40,5,0,0,0,0,0,45
1120246,44,0,0,0,0,0,0,44
1120247,31,0,0,0,0,0,0,31
1120248,52,3,0,0,0,0,0,55
1120249,40,0,3,0,0,0,0,43
1120250,45,8,0,0,0,0,0,53
1120251,34,6,0,0,0,3,0,43
1120252,27,3,0,0,0,0,0,30
1120253,29,6,0,0,0,0,0,35
1120301,28,3,0,0,0,0,0,31
1120302,15,0,0,0,0,0,0,15
1120303,17,4,0,0,0,0,0,21
1120304,4,3,0,0,0,0,0,7
1120305,19,3,3,0,0,0,0,25
1120306,29,0,0,0,0,0,0,29
1120307,27,0,0,0,0,0,0,27
1120308,19,3,4,0,0,0,0,26
1120309,37,5,0,0,0,0,0,42
1120310,12,3,0,0,0,0,0,15
1120311,9,3,0,0,0,0,0,12
1120312,29,3,0,0,0,0,0,32
1120313,19,3,0,0,0,0,0,22
1120314,46,3,3,0,0,0,0,52
1120315,32,0,0,0,0,0,0,32
1120316,35,0,0,0,0,0,0,35
1120317,37,4,0,0,0,0,0,41
1120318,49,5,0,0,0,0,0,54
1120319,36,3,3,0,0,0,0,42
1120320,52,0,5,0,0,0,0,57
1120321,18,0,3,0,0,0,0,21
1120322,57,3,0,0,0,0,0,60
1120323,15,6,3,3,0,0,0,27
1120324,27,4,0,3,0,0,0,34
1120325,71,11,15,0,0,0,0,97
1120326,36,3,3,0,0,0,3,45
1120327,30,3,3,0,3,0,0,39
1120328,41,3,4,0,0,0,0,48
1120329,62,5,0,0,0,0,0,67
1120330,38,5,4,0,0,0,4,51
1120331,3,0,0,0,0,0,0,3
1120332,0,0,0,0,0,0,0,0
1120333,27,6,3,0,0,0,0,36
1120334,19,7,0,0,0,0,0,26
1120335,52,4,6,0,0,0,0,62
1120336,21,0,6,0,0,0,0,27
1120401,0,0,0,0,0,0,0,0
1120402,25,3,3,3,0,0,0,34
1120403,36,3,5,0,0,0,0,44
1120404,26,3,3,0,0,0,0,32
1120405,9,4,4,0,0,0,0,17
1120406,15,3,0,0,0,0,0,18
1120407,77,6,10,3,0,0,3,99
1120408,56,3,7,0,0,0,0,66
1120409,48,9,0,0,0,0,0,57
1120410,20,6,0,0,0,0,0,26
1120411,26,0,7,3,3,0,0,39
1120412,41,3,7,0,0,0,0,51
1120413,22,3,3,3,0,3,0,34
1120501,7,0,0,0,0,0,0,7
1120502,25,0,3,0,0,0,0,28
1120503,20,0,0,0,0,0,0,20
1120504,28,0,0,0,0,0,0,28
1120505,31,4,0,0,0,0,0,35
1120506,56,6,3,3,0,0,0,68
1120507,44,3,3,0,0,0,0,50
1120508,28,7,0,0,0,0,0,35
1120509,20,3,0,0,0,0,3,26
1120510,34,3,0,0,0,0,0,37
1120511,32,3,0,0,0,0,0,35
1120512,170,11,6,0,0,0,0,187
1120513,48,3,0,3,0,0,0,54
1120514,65,8,5,0,0,0,3,81
1120515,36,5,0,0,0,0,0,41
1120516,29,3,0,3,0,0,0,35
1120517,38,3,3,0,0,0,0,44
1120518,30,3,0,0,0,0,0,33
1120519,27,0,0,0,0,0,0,27
1120520,13,0,0,0,0,0,0,13
1120521,23,0,0,0,0,0,0,23
1120522,12,3,0,0,0,0,0,15
1120523,16,4,3,3,0,0,0,26
1120524,18,3,0,0,0,0,0,21
1120525,12,4,3,0,0,0,0,19
1120526,24,0,3,0,0,0,0,27
1120527,48,5,0,0,0,0,0,53
1120528,44,8,3,0,0,0,0,55
1120529,62,3,0,4,0,0,3,72
1120530,11,4,0,0,0,0,0,15
1120531,27,3,0,0,0,0,0,30
1120532,27,5,3,0,0,0,0,35
1120533,23,3,3,3,0,0,0,32
1120534,20,3,3,0,0,0,0,26
1120535,16,0,5,0,0,0,0,21
1120536,15,0,3,0,0,0,0,18
1120537,30,3,0,0,0,0,0,33
1120538,54,11,3,0,0,0,4,72
1120539,27,3,3,0,0,0,0,33
1120540,16,0,0,0,0,0,0,16
1120541,27,4,0,0,0,0,0,31
1120542,46,5,0,0,0,0,3,54
1120543,43,0,0,0,0,0,0,43
1120544,43,0,0,0,0,3,0,46
1120545,36,0,0,0,0,0,0,36
1120546,29,3,5,0,0,0,0,37
1120547,44,3,3,0,0,0,0,50
1120548,28,3,3,3,0,0,0,37
1120549,23,3,3,3,0,0,0,32
1120550,35,6,6,0,0,0,0,47
1120551,20,4,0,0,0,0,0,24
1120552,70,3,3,0,0,0,0,76
1120601,13,0,0,0,0,0,0,13
1120602,39,0,3,0,0,0,0,42
1120603,35,0,0,0,0,0,0,35
1120604,43,8,0,0,0,0,0,51
1120605,43,3,5,0,0,0,0,51
1120606,25,7,0,0,0,0,0,32
1120607,0,0,0,0,0,0,0,0
1120608,32,0,0,0,0,0,0,32
1120609,36,9,4,0,0,0,0,49
1120610,82,8,0,0,0,0,0,90
1120611,53,3,6,4,0,0,0,66
1120612,65,4,7,0,0,0,0,76
1120613,31,0,0,3,0,0,0,34
1120614,41,3,0,0,0,0,0,44
1120615,65,10,0,0,0,0,0,75
1120616,48,6,3,0,0,0,0,57
1120617,29,0,3,3,0,0,0,35
1120618,51,5,0,0,0,0,0,56
1120619,60,5,7,3,0,0,0,75
1120620,60,6,0,0,0,0,3,69
1120621,76,3,3,0,0,0,0,82
1120622,31,3,3,3,0,0,0,40
1120623,67,14,4,0,0,0,0,85
1120624,39,4,3,0,0,0,0,46
1120625,55,4,3,0,0,0,0,62
1120626,72,3,6,3,0,0,0,84
1120627,85,4,3,4,0,0,0,96
1120628,53,3,6,0,0,0,0,62
1120629,17,3,0,0,0,0,0,20
1120630,12,3,0,0,0,0,0,15
1120631,19,3,3,0,0,0,0,25
1120632,26,0,0,0,0,0,0,26
1120633,27,3,3,3,0,0,0,36
1120634,49,5,3,0,0,0,0,57
1120635,19,3,3,0,0,0,0,25
1120636,19,3,4,4,3,0,0,33
1120637,41,0,3,0,0,0,3,47
1120638,60,4,0,0,0,0,0,64
1120639,23,3,0,0,0,0,0,26
1120640,53,7,4,3,0,0,0,67
1120641,67,8,3,0,0,0,0,78
1120642,26,0,0,3,0,0,0,29
1120701,45,4,0,0,0,0,0,49
1120702,49,0,0,3,0,4,0,56
1120703,47,3,3,0,0,0,0,53
1120704,30,0,0,0,0,0,0,30
1120705,25,4,3,0,0,0,3,35
1120706,22,0,4,0,0,0,0,26
1120707,22,0,5,0,0,0,0,27
1120708,31,6,3,0,0,0,0,40
1120709,32,5,4,4,0,0,0,45
1120710,0,0,0,0,0,0,0,0
1120711,37,7,0,0,0,0,0,44
1120712,25,3,3,0,0,0,0,31
1120713,24,3,0,0,0,0,0,27
1120714,0,0,0,0,0,0,0,0
1120715,46,7,3,0,0,0,0,56
1120716,19,3,4,3,0,0,0,29
1120801,38,3,3,0,0,0,3,47
1120802,26,0,3,0,0,0,0,29
1120803,22,0,0,0,0,0,0,22
1120804,33,4,0,0,0,0,0,37
1120805,50,6,0,4,0,0,0,60
1120806,33,0,0,0,0,0,0,33
1120807,44,8,0,0,0,0,3,55
1120808,74,0,0,0,0,0,0,74
1120809,32,3,3,0,0,0,0,38
1120810,43,5,0,0,0,0,3,51
1120811,46,3,0,0,0,0,0,49
1120812,43,4,4,0,0,0,0,51
1120813,26,4,0,0,0,0,0,30
1120814,45,5,0,0,0,0,4,54
1120815,46,0,3,0,0,0,0,49
1120816,34,0,4,0,0,0,0,38
1120817,56,9,0,0,0,0,0,65
1120818,23,3,0,3,0,0,0,29
1120819,29,4,3,0,0,0,0,36
1120820,26,3,3,0,0,0,0,32
1120821,46,5,0,0,0,0,0,51
1120822,49,3,3,0,0,0,0,55
1120823,0,0,0,0,0,0,0,0
1120824,21,0,0,0,0,0,0,21
1120825,36,8,7,0,0,0,3,54
1120826,51,8,5,0,0,0,0,64
1120827,74,0,0,0,0,0,0,74
1120828,53,7,0,0,0,0,3,63
1120829,35,3,3,0,0,0,0,41
1120830,29,3,3,0,0,0,0,35
1120831,39,3,3,0,0,0,0,45
1120832,49,0,0,0,0,0,0,49
1120833,41,5,0,0,0,0,0,46
1120834,43,3,3,0,0,0,0,49
1120835,36,0,3,0,0,0,0,39
1120836,39,7,3,0,0,0,0,49
1120837,35,0,10,0,0,0,0,45
1120838,20,3,0,0,0,0,0,23
1120839,26,0,0,0,0,0,0,26
1120840,38,3,4,3,0,0,0,48
1120841,43,7,3,0,0,0,0,53
1120842,33,0,4,0,0,0,0,37
1120843,11,4,0,0,0,0,0,15
1120844,6,0,0,0,0,0,0,6
1120845,50,3,3,3,0,0,0,59
1120846,73,0,0,0,0,0,0,73
1120847,30,3,0,0,0,0,0,33
1120848,37,0,0,0,0,0,0,37
1120849,49,0,0,0,0,0,0,49
1120850,40,0,0,0,0,0,0,40
1120851,19,5,3,0,0,0,0,27
1120852,31,3,3,0,0,0,0,37
1120853,41,0,0,3,0,0,0,44
1120854,34,0,0,0,0,0,0,34
1120855,60,0,5,0,0,0,0,65
1120856,30,3,3,0,0,0,3,39
1120857,37,4,0,0,0,0,0,41
1120858,30,0,0,0,0,0,3,33
1120859,46,3,4,0,0,0,0,53
1120860,51,10,3,0,0,0,0,64
1120861,28,0,6,0,0,0,0,34
1120862,25,3,3,3,0,0,0,34
1120863,18,4,0,0,0,0,0,22
1120864,55,3,5,0,0,0,0,63
1120865,3,0,0,0,0,0,0,3
1120866,22,4,0,0,0,0,0,26
1120901,33,8,3,0,0,0,0,44
1120902,0,0,0,0,0,0,0,0
1120903,45,0,0,0,0,3,0,48
1120904,43,0,3,0,0,3,0,49
1120905,27,10,4,0,0,0,0,41
1120906,41,4,3,0,0,0,0,48
1120907,30,3,4,0,0,0,0,37
1120908,17,3,3,0,0,0,0,23
1120909,24,0,4,0,0,0,0,28
1120910,35,0,3,0,0,0,3,41
1120911,46,0,3,0,0,0,0,49
1120912,30,7,0,0,0,0,0,37
1120913,63,6,3,0,0,0,0,72
1120914,48,4,5,0,0,0,0,57
1120915,83,7,3,0,0,0,0,93
1120916,49,0,3,0,0,0,0,52
1120917,76,6,0,0,0,0,0,82
1120918,57,0,5,0,0,0,0,62
1120919,44,0,3,3,0,0,0,50
1120920,52,5,5,0,0,0,0,62
1120921,68,4,6,3,0,0,0,81
1120922,60,3,3,0,0,0,0,66
1120923,47,8,3,0,0,0,0,58
1120924,49,0,0,0,0,0,0,49
1120925,40,0,7,3,0,0,0,50
1120926,31,3,3,0,0,0,3,40
1120927,50,7,0,4,0,0,0,61
1120928,68,7,3,0,0,0,0,78
1120929,38,5,3,0,0,0,0,46
1120930,59,3,3,0,0,0,0,65
1120931,34,0,5,4,0,0,0,43
1120932,46,8,3,3,0,0,0,60
1120933,27,4,3,0,0,0,0,34
1120934,24,3,3,0,0,0,3,33
1120935,36,0,3,0,0,0,0,39
1120936,34,8,0,0,0,0,0,42
1120937,0,0,0,0,0,0,0,0
1120938,0,0,0,0,0,0,0,0
1120939,73,3,4,0,0,0,0,80
1120940,29,3,3,3,0,0,0,38
1120941,61,0,5,0,0,0,0,66
1120942,57,0,3,0,0,0,3,63
1120943,50,7,0,0,0,0,0,57
1120944,61,3,3,0,0,0,0,67
1120945,56,8,3,0,0,0,0,67
1120946,59,6,3,0,0,0,0,68
1120947,60,9,3,3,0,0,0,75
1120948,52,7,0,4,0,0,0,63
1120949,26,3,3,0,0,0,3,35
1120950,41,9,3,0,0,0,0,53
1120951,28,3,0,0,0,0,0,31
1120952,52,4,0,3,0,0,0,59
1120953,59,3,0,0,0,0,3,65
1120954,69,5,0,4,0,0,0,78
1120955,52,3,5,0,0,0,0,60
1120956,66,4,3,0,0,0,0,73
1121001,6,3,0,0,0,0,3,12
1121002,24,4,0,0,0,0,0,28
1121003,52,5,3,0,0,0,0,60
1121004,32,7,0,0,0,0,0,39
1121005,36,4,4,0,0,0,0,44
1121006,31,7,3,3,0,0,0,44
1121007,61,4,4,0,0,0,3,72
1121008,50,6,5,0,0,0,0,61
1121009,71,13,10,3,0,0,0,97
1121010,3,0,3,0,0,0,0,6
1121011,28,0,3,0,3,0,0,34
1121012,17,3,0,3,0,0,0,23
1121013,29,6,3,3,0,0,3,44
1121014,25,3,0,0,0,0,0,28
1121015,34,0,0,0,0,0,3,37
1121016,53,3,4,0,0,0,0,60
1121017,51,3,3,0,0,0,0,57
1121018,23,5,4,0,0,0,4,36
1121019,14,0,0,0,0,0,4,18
1121020,21,0,0,3,0,0,0,24
1121021,31,3,0,0,0,0,0,34
1121022,23,3,8,0,0,3,0,37
1121101,31,3,4,0,0,0,0,38
1121102,40,3,0,0,0,0,0,43
1121103,10,0,0,0,0,0,3,13
1121104,57,4,3,0,0,0,0,64
1121105,39,0,0,0,0,0,0,39
1121106,41,8,3,0,0,0,0,52
1121107,36,3,3,3,0,0,0,45
1121108,87,3,6,0,0,0,0,96
1121109,0,0,0,0,0,0,0,0
1121110,56,8,0,0,0,0,0,64
1121201,67,5,3,3,0,0,0,78
1121202,37,8,3,0,0,0,3,51
1121203,27,4,0,0,0,0,0,31
1121204,34,3,4,3,0,0,0,44
1121205,30,0,4,0,0,0,0,34
1121206,28,0,3,0,0,3,3,37
1121207,48,5,3,0,0,0,0,56
1121208,39,6,5,0,0,0,0,50
1121209,45,4,0,0,0,0,0,49
1121210,32,0,3,0,0,0,0,35
1121211,27,0,0,0,0,0,3,30
1121212,69,5,0,0,0,0,0,74
1121213,22,4,0,5,0,0,0,31
1121214,50,3,0,0,0,0,0,53
1121215,32,4,0,0,0,0,0,36
1121216,23,0,0,0,0,0,4,27
1121217,31,4,0,0,0,0,4,39
1121218,3,3,0,0,0,0,0,6
1121219,27,7,0,0,0,0,0,34
1121220,0,0,0,0,0,0,0,0
1121221,26,3,0,0,0,0,0,29
1121222,62,8,0,0,0,0,0,70
1121223,32,3,0,0,0,0,0,35
1121224,72,8,3,0,0,0,3,86
1121225,54,8,0,0,0,0,0,62
1121226,33,0,3,0,0,3,4,43
1121227,71,3,3,0,0,0,0,77
1121301,0,0,0,0,0,0,0,0
1121302,0,0,0,0,0,0,0,0
1121303,53,8,0,0,0,0,0,61
1121304,64,0,0,0,0,0,0,64
1121305,72,3,3,3,0,0,0,81
1121306,45,3,0,0,0,0,3,51
1121307,61,4,0,0,0,0,0,65
1121308,66,5,3,0,0,0,0,74
1121309,30,3,0,0,0,0,0,33
1121310,64,5,0,0,0,0,0,69
1121311,58,5,3,0,0,0,0,66
1121312,54,5,0,0,0,0,0,59
1121313,35,0,4,0,0,0,0,39
1121314,62,3,3,0,0,0,0,68
1121315,70,10,4,0,0,0,0,84
1121316,38,0,0,0,0,0,0,38
1121317,62,7,4,0,0,0,0,73
1121318,80,3,0,0,0,3,0,86
1121319,60,0,0,0,0,0,0,60
1121320,22,8,0,0,0,0,0,30
1121321,50,4,0,0,0,0,0,54
1121322,75,4,6,0,0,0,0,85
1121323,87,0,4,3,0,0,0,94
1121324,58,6,0,0,0,0,0,64
1121325,58,6,5,0,0,0,0,69
1121326,53,4,0,0,0,0,0,57
1121327,33,6,0,0,0,0,0,39
1121328,59,4,0,0,0,0,0,63
1121329,34,0,4,0,0,0,0,38
1121330,51,3,3,0,0,0,0,57
1121401,43,3,5,0,0,0,0,51
1121402,34,7,0,0,0,0,0,41
1121403,61,6,3,0,0,0,0,70
1121404,39,0,3,0,0,0,0,42
1121405,0,0,0,0,0,0,0,0
1121406,74,7,3,0,0,0,0,84
1121407,30,4,4,4,0,0,0,42
1121408,21,4,5,0,0,0,0,30
1121409,27,0,0,0,0,0,0,27
1121410,40,10,3,0,0,0,0,53
1121411,54,5,3,0,0,0,0,62
1121412,18,3,0,0,0,0,0,21
1121413,71,3,3,0,0,0,0,77
1121414,55,4,4,0,0,0,0,63
1121415,38,8,5,0,0,0,3,54
1121416,36,4,5,4,0,0,0,49
1121417,21,3,3,0,0,0,0,27
1121418,0,0,0,0,0,0,0,0
1121419,32,3,3,0,0,0,0,38
1121420,0,0,0,0,0,0,0,0
1121421,41,3,0,0,0,0,0,44
1121422,49,3,3,0,0,0,0,55
1121423,46,3,4,0,0,0,0,53
1121424,18,0,4,0,0,4,0,26
1121425,34,5,3,4,0,0,0,46
1121426,37,4,3,3,0,0,0,47
1121427,33,4,0,0,0,0,0,37
1121428,46,5,4,3,0,0,0,58
1121429,38,0,0,0,0,4,0,42
1121430,51,4,0,5,0,0,0,60
1121431,31,3,0,0,0,0,0,34
1121432,64,7,0,0,0,0,0,71
1121433,44,7,3,0,0,0,0,54
1121434,28,5,0,0,0,0,0,33
1121501,26,0,4,0,0,0,0,30
1121502,38,0,0,0,0,0,0,38
1121503,26,0,3,3,0,0,0,32
1121504,47,4,5,0,3,0,0,59
1121505,37,0,0,0,0,0,0,37
1121506,44,0,4,0,0,0,0,48
1121507,28,3,3,0,0,0,0,34
1121508,20,5,3,0,0,0,0,28
1121509,37,7,3,0,0,0,0,47
1121510,31,6,0,4,0,0,0,41
1121511,47,5,3,0,0,0,3,58
1121512,33,3,3,0,0,0,0,39
1121513,57,3,8,0,0,0,0,68
1121514,23,5,0,0,0,0,0,28
1121515,0,0,0,0,0,0,0,0
1121516,32,9,3,0,0,0,0,44
1121517,18,3,3,0,0,0,0,24
1121518,21,10,3,0,0,0,0,34
1121519,26,3,0,0,0,0,0,29
1121520,24,3,3,0,0,0,0,30
1121521,3,3,0,0,0,0,0,6
1121522,46,4,6,0,0,0,0,56
1121523,0,0,0,0,0,0,0,0
1121524,35,0,3,3,0,0,0,41
1121525,28,3,4,0,0,0,0,35
1121601,38,0,0,0,0,0,0,38
1121602,35,6,0,0,0,0,0,41
1121603,74,8,5,0,0,0,3,90
1121604,37,0,0,0,0,0,0,37
1121605,24,0,4,0,0,0,0,28
1121606,47,5,4,0,0,0,0,56
1121607,43,5,5,0,0,0,0,53
1121608,41,7,6,0,0,0,3,57
1121609,38,8,4,0,0,0,0,50
1121610,25,3,4,0,0,0,0,32
1121611,30,0,3,0,0,0,3,36
1121612,66,13,0,3,0,0,0,82
1121613,33,0,3,0,0,0,0,36
1121614,28,4,3,0,0,0,0,35
1121615,42,7,0,6,0,0,0,55
1121616,42,4,3,0,0,0,0,49
1121617,48,11,4,0,0,0,0,63
1121701,0,0,0,0,0,0,0,0
1121702,58,10,0,0,0,0,0,68
1121703,18,3,0,3,0,3,0,27
1121704,61,3,0,0,0,0,0,64
1121705,32,3,5,0,0,0,0,40
1121706,40,4,6,3,0,0,0,53
1121707,13,5,0,0,0,0,0,18
1121708,30,3,6,0,0,0,0,39
1121709,39,5,0,0,0,0,0,44
1121710,19,3,0,0,0,0,0,22
1121711,61,7,9,0,0,0,0,77
1121712,38,8,0,0,0,0,0,46
1121713,22,3,3,0,0,0,0,28
1121714,51,3,3,3,0,0,0,60
1121715,6,0,0,0,0,0,0,6
1121716,51,7,0,0,0,0,0,58
1121717,111,12,13,0,0,0,0,136
1121718,0,0,0,0,0,0,0,0
1121719,33,3,0,0,0,0,0,36
1121720,15,3,0,0,0,0,3,21
1121721,54,4,7,0,0,0,0,65
1121722,63,5,6,0,0,0,0,74
1121723,85,9,6,0,0,3,0,103
1121724,64,4,0,0,0,0,0,68
1121725,83,3,9,0,0,0,0,95
1121726,11,0,0,0,0,0,0,11
1121727,0,0,0,0,0,0,0,0
1121728,81,3,3,0,0,0,0,87
1121729,67,3,3,0,0,0,0,73
1121730,47,3,3,0,0,0,0,53
1121731,56,7,5,0,0,0,0,68
1121801,52,5,0,0,0,0,0,57
1121802,21,4,3,0,0,0,0,28
1121803,31,3,3,0,0,0,0,37
1121804,0,0,0,0,0,0,0,0
1121805,23,6,3,3,0,0,0,35
1121806,0,0,0,0,0,0,0,0
1121807,12,0,0,0,0,0,0,12
1121808,23,4,0,0,0,0,0,27
1121809,34,4,3,0,0,0,0,41
1121810,35,0,0,0,0,0,0,35
1121811,44,4,3,0,0,3,0,54
1121812,55,3,8,0,0,0,0,66
1121813,26,0,6,0,0,0,0,32
1121814,51,10,4,0,0,0,0,65
1121815,29,7,0,3,0,0,0,39
1121816,52,3,0,0,0,0,0,55
1121817,0,0,0,0,0,0,0,0
1121818,17,3,0,0,0,0,0,20
1121819,18,7,3,0,0,0,0,28
1121820,21,0,3,0,0,0,0,24
1121821,27,0,4,0,0,0,0,31
1121822,49,7,3,0,0,0,0,59
1121823,25,3,0,0,0,0,0,28
1121824,3,0,0,0,0,0,0,3
1121825,38,6,3,0,0,0,0,47
1121826,34,6,0,0,0,0,0,40
1121827,12,3,0,0,3,0,0,18
1121828,38,0,7,0,3,0,0,48
1121829,12,4,0,0,0,0,0,16
1121830,0,0,0,0,0,0,0,0
1121831,19,0,3,0,0,0,0,22
1121832,5,0,0,0,0,0,0,5
1121833,30,3,3,0,0,0,3,39
1121834,76,4,3,0,0,0,0,83
1121835,33,4,3,3,0,0,0,43
1121836,24,3,3,0,0,0,0,30
1121837,56,4,3,0,0,0,3,66
1121838,11,0,0,0,0,0,0,11
1121839,16,3,5,0,0,0,3,27
1121840,56,0,5,0,0,0,0,61
1121841,36,5,0,0,0,0,0,41
1121842,35,3,0,0,0,0,0,38
1121843,22,3,4,0,0,0,0,29
1121901,25,0,3,0,0,0,0,28
1121902,21,3,3,0,0,0,0,27
1121903,30,0,3,0,0,0,0,33
1121904,36,4,5,0,0,0,4,49
1121905,22,0,3,0,0,0,0,25
1121906,17,3,3,0,0,0,3,26
1121907,13,0,0,0,0,0,0,13
1121908,50,4,4,0,0,0,0,58
1121909,34,6,0,0,0,0,0,40
1121910,35,4,0,0,0,0,3,42
1121911,42,6,0,0,0,0,0,48
1121912,13,0,3,0,0,0,0,16
1121913,31,0,0,0,0,0,0,31
1121914,48,7,4,0,0,0,0,59
1121915,29,3,0,0,0,0,0,32
1121916,18,5,0,0,0,0,3,26
1121917,48,4,3,0,0,0,0,55
1121918,23,0,7,0,0,0,0,30
1121919,25,4,0,0,0,0,0,29
1121920,24,0,4,0,0,0,0,28
1121921,0,0,0,0,0,0,0,0
1121922,10,3,0,0,0,0,0,13
1121923,57,7,0,0,0,0,0,64
1121924,23,0,0,0,0,0,0,23
1121925,41,4,3,0,0,0,0,48
1121926,41,3,0,0,0,0,0,44
1121927,0,0,0,0,0,0,0,0
1121928,26,0,6,0,0,0,0,32
1121929,9,10,0,0,3,0,0,22
1121930,37,6,4,0,0,0,0,47
1121931,53,5,4,0,0,0,0,62
1121932,49,11,3,3,0,0,0,66
1121933,14,4,0,4,0,0,0,22
1121934,26,3,3,0,0,0,0,32
1121935,26,4,4,0,0,0,0,34
1121936,38,0,0,4,0,0,0,42
1121937,26,6,3,0,0,0,0,35
1121938,57,4,4,0,0,0,0,65
1121939,25,3,3,0,0,0,0,31
1122001,52,0,4,0,0,0,0,56
1122002,33,3,3,0,0,0,0,39
1122003,45,4,0,0,0,0,0,49
1122004,42,3,3,0,0,0,0,48
1122005,43,12,0,3,0,0,0,58
1122006,51,3,3,0,0,0,0,57
1122007,36,3,3,0,0,0,0,42
1122008,4,0,0,0,0,0,0,4
1122009,38,7,0,0,0,0,0,45
1122010,38,13,3,0,0,0,0,54
1122011,58,10,3,0,0,0,0,71
1122012,39,5,0,0,0,0,0,44
1122013,54,3,3,0,0,0,0,60
1122014,24,4,4,0,0,0,0,32
1122015,26,3,3,0,0,0,0,32
1122016,49,7,4,0,0,0,0,60
1122017,43,7,0,0,0,0,0,50
1122018,22,3,0,0,0,0,0,25
1122019,24,6,0,0,0,0,3,33
1122020,49,10,8,0,0,0,0,67
1122021,38,11,4,0,0,0,0,53
1122101,42,7,5,0,0,0,0,54
1122102,19,3,0,0,0,0,0,22
1122103,45,4,4,0,0,0,0,53
1122104,44,0,7,3,0,0,0,54
1122105,25,5,7,0,0,3,0,40
1122106,42,9,4,0,0,0,0,55
1122107,38,3,4,0,3,0,0,48
1122108,17,0,5,0,0,0,0,22
1122109,33,3,5,0,0,0,0,41
1122110,54,0,0,0,0,0,5,59
1122111,55,5,0,0,0,0,0,60
1122112,39,4,4,3,0,0,0,50
1122113,42,5,0,0,0,0,0,47
1122114,24,5,4,0,0,0,0,33
1122115,36,4,3,0,0,0,3,46
1122116,25,0,0,0,0,0,0,25
1122117,31,3,3,0,0,0,3,40
1122118,30,0,0,0,0,0,0,30
1122119,23,0,3,0,0,0,0,26
1122120,24,3,3,0,0,0,0,30
1122201,42,5,4,0,0,0,0,51
1122202,44,0,3,0,0,0,0,47
1122203,35,8,0,0,0,0,0,43
1122204,63,8,0,0,0,0,0,71
1122205,48,0,0,0,0,0,0,48
1122206,61,3,3,0,0,0,0,67
1122207,56,4,3,0,0,0,0,63
1122208,33,0,3,0,0,0,0,36
1122209,42,4,3,0,0,0,0,49
1122210,39,0,6,0,0,0,0,45
1122211,58,0,0,0,0,0,0,58
1122212,49,5,0,0,0,0,0,54
1122213,23,3,0,0,3,0,0,29
1122214,29,3,3,0,0,0,0,35
1122215,45,3,0,0,0,0,0,48
1122216,62,6,0,0,0,0,0,68
1122217,58,4,0,0,0,0,0,62
1122218,36,0,0,0,0,0,3,39
1122219,28,6,3,0,0,0,0,37
1122220,38,5,0,0,0,0,0,43
1122221,0,0,0,0,0,0,0,0
1122222,0,0,0,0,0,0,0,0
1122223,67,3,3,0,0,0,0,73
1122224,44,5,3,3,0,0,0,55
1122225,42,3,3,0,0,0,0,48
1122226,46,4,3,0,0,0,0,53
1122227,71,4,0,0,0,0,0,75
1122228,39,0,7,3,0,0,0,49
1122229,42,6,0,0,0,0,0,48
1122230,58,3,0,0,0,0,0,61
1122231,41,3,0,0,0,0,0,44
1122232,53,3,3,3,0,0,0,62
1122233,47,3,3,0,0,0,0,53
1122234,45,4,0,0,0,0,0,49
1122235,73,3,3,0,0,0,0,79
1122236,34,3,0,0,0,0,0,37
1122237,0,0,0,0,0,0,0,0
1122238,0,0,0,0,0,0,0,0
1122239,19,0,0,0,0,0,0,19
1122240,56,3,0,0,0,0,0,59
1122301,21,3,3,0,0,0,0,27
1122302,44,4,4,0,0,0,0,52
1122303,44,7,5,0,0,0,0,56
1122304,26,4,3,0,0,0,0,33
1122305,40,0,6,0,0,0,0,46
1122306,32,4,4,0,0,0,4,44
1122307,30,4,3,0,0,0,0,37
1122308,37,3,3,3,0,0,0,46
1122309,5,0,0,0,0,0,0,5
1122310,45,0,8,0,0,0,0,53
1122311,41,8,3,0,0,0,0,52
1122312,36,9,0,0,0,0,0,45
1122313,31,4,5,0,0,0,0,40
1122314,46,0,0,0,0,0,0,46
1122315,38,4,0,0,0,0,0,42
1122316,15,5,0,0,0,0,0,20
1122317,31,5,4,0,0,0,0,40
1122318,32,7,0,0,0,0,0,39
1122319,19,5,5,0,0,0,0,29
1122320,19,6,5,0,0,0,0,30
1122321,16,0,4,0,0,0,0,20
1122322,30,3,10,0,0,0,0,43
1122323,30,3,3,0,0,0,0,36
1122401,59,3,3,0,0,0,0,65
1122402,46,3,0,0,0,0,0,49
1122403,9,0,3,0,0,0,0,12
1122404,41,0,4,0,0,0,0,45
1122405,11,3,3,0,0,0,0,17
1122406,10,0,0,0,0,0,0,10
1122407,7,3,0,0,0,0,0,10
1122408,24,0,0,0,0,0,0,24
1122409,0,0,0,0,0,0,0,0
1122410,0,0,0,0,0,0,0,0
1122411,34,6,0,0,0,0,4,44
1122412,41,3,4,0,0,0,0,48
1122413,32,4,0,0,0,0,0,36
1122414,27,5,0,0,0,0,0,32
1122415,26,3,3,0,0,0,0,32
1122416,0,0,0,0,0,0,0,0
1122417,14,0,0,0,0,0,0,14
1122418,38,3,0,0,0,0,0,41
1122419,27,5,3,0,0,0,0,35
1122420,5,3,0,0,0,0,0,8
1122421,36,10,3,0,0,0,0,49
1122422,67,4,3,0,0,0,0,74
1122423,25,3,0,0,0,0,0,28
1122424,19,7,4,0,0,0,0,30
1122425,21,7,0,0,0,0,0,28
1122426,38,5,0,0,0,0,0,43
1122427,71,8,3,0,0,0,0,82
1122428,43,3,0,0,0,0,0,46
1122429,65,3,0,0,0,0,0,68
1122430,57,0,3,0,0,0,0,60
1122431,58,3,3,0,0,0,3,67
1122432,26,0,3,0,0,0,0,29
1122501,58,3,4,0,0,0,0,65
1122502,32,0,4,0,0,0,0,36
1122503,46,3,3,0,0,0,0,52
1122504,36,5,3,0,0,0,0,44
1122505,52,3,3,0,0,0,0,58
1122506,27,0,4,0,0,0,0,31
1122507,47,3,3,0,0,0,0,53
1122508,82,5,0,0,0,0,0,87
1122509,31,3,3,0,0,0,0,37
1122510,30,0,0,0,0,0,0,30
1122511,44,0,0,0,0,0,0,44
1122512,44,3,0,0,0,0,0,47
1122513,87,4,0,0,0,0,0,91
1122514,31,3,3,0,0,0,0,37
1122515,36,3,0,0,0,0,3,42
1122516,33,0,6,0,0,0,0,39
1122517,30,8,0,0,0,0,0,38
1122518,45,0,3,0,0,3,0,51
1122519,34,4,0,3,0,0,0,41
1122520,30,0,0,0,0,0,0,30
1122521,66,5,0,0,0,0,0,71
1122522,52,4,4,0,0,0,0,60
1122523,24,5,5,0,0,0,0,34
1122524,50,7,0,0,0,0,0,57
1122525,39,0,3,0,0,0,0,42
1122526,82,8,0,0,0,0,0,90
1122527,24,3,0,0,0,0,0,27
1122528,54,3,0,3,0,0,0,60
1122529,33,3,0,0,0,0,0,36
1122530,58,4,3,0,0,0,0,65
1122531,29,0,0,0,0,0,0,29
1122532,28,0,0,0,0,0,0,28
1122533,0,0,0,0,0,0,0,0
1122534,60,4,0,0,0,0,0,64
1122535,0,0,0,0,0,0,0,0
1122536,41,4,4,0,0,0,0,49
1122537,50,0,0,0,0,0,0,50
1122538,26,7,0,0,0,0,0,33
1122539,30,0,3,0,0,0,3,36
1122540,43,9,0,0,0,0,0,52
1122541,24,3,3,0,0,0,0,30
1122542,22,3,3,0,0,0,0,28
1122543,45,4,0,5,0,0,0,54
1122601,61,4,0,0,0,0,0,65
1122602,26,0,0,0,0,0,0,26
1122603,90,7,9,3,0,0,0,109
1122604,36,4,0,0,0,0,0,40
1122605,86,5,5,0,0,0,0,96
1122606,42,0,4,0,0,0,0,46
1122607,77,10,3,3,0,0,0,93
1122608,70,3,3,0,0,0,0,76
1122609,62,13,4,0,0,0,0,79
1122610,27,3,3,0,0,0,3,36
1122611,21,3,4,3,0,0,0,31
1122612,28,3,3,0,0,0,0,34
1122613,29,3,3,0,0,0,0,35
1122614,79,5,0,0,0,0,0,84
1122615,62,6,7,3,0,0,0,78
1122616,38,5,0,0,0,0,0,43
1122617,47,3,3,0,0,0,0,53
1122618,47,9,3,0,0,0,0,59
1122619,30,4,3,0,0,0,0,37
1122620,25,4,0,0,0,0,0,29
1122621,31,0,0,0,0,0,0,31
1122622,0,0,0,0,0,0,0,0
1122623,34,3,3,0,3,3,0,46
1122624,52,5,5,0,0,0,0,62
1122625,50,7,4,0,0,0,0,61
1122626,47,4,7,0,0,0,0,58
1122627,31,3,4,0,0,0,3,41
1122628,49,6,4,0,0,0,0,59
1122629,55,7,5,0,0,0,0,67
1122630,94,9,4,0,0,0,0,107
1122631,0,0,0,0,0,0,0,0
1122632,48,5,3,3,0,0,3,62
1122701,24,3,0,3,0,0,0,30
1122702,0,0,0,0,0,0,0,0
1122703,16,0,0,0,0,0,0,16
1122704,21,4,3,3,0,0,3,34
1122705,21,6,3,0,0,0,0,30
1122706,32,4,0,0,0,0,0,36
1122707,44,3,0,0,0,0,4,51
1122708,39,6,3,0,0,0,0,48
1122709,26,3,0,0,0,0,0,29
1122710,32,7,5,0,0,0,0,44
1122711,25,7,4,0,0,0,0,36
1122712,15,0,4,0,0,0,0,19
1122713,48,7,6,0,0,0,0,61
1122714,40,3,3,0,0,0,0,46
1122715,29,6,0,0,0,0,0,35
1122716,21,0,0,0,0,0,4,25
1122717,39,5,0,0,0,0,0,44
1122718,32,4,3,3,0,0,0,42
1122719,32,6,3,0,0,0,0,41
1122720,31,0,4,0,0,0,0,35
1122721,30,3,3,0,0,0,0,36
1122722,6,0,0,0,0,0,0,6
1122723,18,4,0,0,0,0,0,22
1122724,34,7,0,0,0,0,0,41
1122725,36,5,6,0,0,0,0,47
1122726,32,0,3,0,0,0,0,35
1122727,33,3,0,3,0,0,3,42
1122728,47,3,3,0,0,0,0,53
1122729,31,4,4,0,0,0,3,42
1122730,32,6,3,0,0,0,0,41
1122731,29,4,4,0,0,0,0,37
1122732,47,4,0,0,0,0,0,51
1122733,21,5,3,0,0,0,0,29
1122734,30,6,3,0,0,0,0,39
1122735,30,6,3,0,0,0,0,39
1122736,36,5,0,0,0,0,0,41
1122801,64,4,4,0,0,0,0,72
1122802,67,6,3,0,0,0,0,76
1122803,0,0,0,0,0,0,0,0
1122804,53,3,0,0,0,0,0,56
1122805,31,0,3,0,0,0,0,34
1122806,77,7,0,0,0,0,0,84
1122807,78,0,0,0,0,0,0,78
1122808,45,6,5,3,0,0,0,59
1122809,38,3,0,0,0,0,3,44
1122810,44,3,0,0,0,0,0,47
1122811,82,3,3,0,0,0,0,88
1122812,63,8,0,0,0,0,0,71
1122813,53,4,3,0,0,0,0,60
1122814,39,3,0,0,0,0,0,42
1122815,20,0,3,0,0,0,0,23
1122816,19,0,0,0,0,0,0,19
1122817,27,8,3,0,0,0,0,38
1122818,66,3,3,0,0,0,0,72
1122819,32,3,0,0,0,0,0,35
1122820,71,0,5,0,0,0,0,76
1122821,58,5,3,0,0,0,0,66
1122822,33,5,0,0,0,0,0,38
1122823,11,0,0,3,0,0,0,14
1122824,15,0,0,0,0,0,0,15
1122825,23,0,3,0,0,0,0,26
1122826,58,4,3,0,0,0,0,65
1122827,26,3,4,0,0,0,0,33
1122828,27,0,4,0,0,0,0,31
1122829,51,5,0,0,0,0,0,56
1122830,27,3,0,0,0,0,3,33
1122831,54,3,3,0,0,0,0,60
1122832,47,0,0,0,0,0,0,47
1122901,14,0,0,0,0,0,0,14
1122902,28,3,3,0,0,0,0,34
1122903,29,0,0,0,0,0,0,29
1122904,20,0,0,0,0,0,0,20
1122905,31,5,0,0,0,0,0,36
1122906,3,3,0,0,0,0,0,6
1122907,20,3,0,0,0,0,0,23
1122908,17,0,0,0,0,0,0,17
1122909,31,4,0,0,0,0,0,35
1122910,19,0,0,0,0,0,0,19
1122911,32,0,3,0,0,0,0,35
1122912,16,3,3,0,0,0,0,22
1122913,16,3,0,0,0,0,0,19
1122914,0,0,0,0,0,0,0,0
1122915,13,0,0,0,0,0,0,13
1122916,23,0,0,0,3,0,0,26
1122917,17,0,3,0,0,0,0,20
1122918,13,4,0,0,0,0,0,17
1122919,33,0,0,0,0,0,0,33
1122920,29,3,0,0,0,0,0,32
1122921,22,3,0,0,0,0,0,25
1122922,51,3,3,0,0,0,0,57
1122923,26,3,0,0,0,0,0,29
1122924,33,0,0,0,0,0,0,33
1122925,39,3,3,0,0,0,0,45
1122926,22,4,0,0,0,0,0,26
1123001,0,0,0,0,0,0,0,0
1123101,22,0,0,0,0,0,0,22
1123102,25,5,3,0,0,0,0,33
1123103,16,0,0,0,0,0,0,16
1123104,55,4,4,0,0,0,0,63
1123105,12,0,0,0,0,0,0,12
1123106,0,0,0,0,0,0,0,0
1123107,8,0,0,3,0,0,0,11
1123108,48,6,3,0,0,0,3,60
1123109,52,3,3,0,0,0,0,58
1123110,31,10,3,0,0,0,0,44
1123111,41,4,5,0,0,0,0,50
1123112,0,0,0,0,0,0,0,0
1123113,35,4,3,0,0,0,3,45
1123114,27,0,0,0,0,0,0,27
1123115,27,6,7,0,0,0,0,40
1123116,27,3,3,0,0,0,0,33
1123117,16,3,3,0,0,0,0,22
1123118,10,0,0,0,0,0,0,10
1123119,22,0,0,3,0,0,0,25
1123120,21,3,0,0,0,0,0,24
1123121,18,3,0,0,0,0,0,21
1123122,41,3,3,0,0,0,0,47
1123123,52,9,0,0,0,0,0,61
1123124,26,3,3,0,0,0,0,32
1123125,0,0,0,0,0,0,0,0
1123126,13,0,0,4,0,0,0,17
1123201,38,0,0,0,0,0,0,38
1123202,43,0,0,0,0,0,0,43
1123203,35,0,0,0,0,0,0,35
1123204,22,7,3,0,0,0,0,32
1123205,26,6,4,0,0,0,0,36
1123206,27,5,0,0,0,0,0,32
1123207,47,10,3,0,0,0,0,60
1123208,33,5,3,0,0,0,3,44
1123209,35,7,3,0,0,0,0,45
1123210,10,0,0,0,0,0,0,10
1123211,0,0,0,0,0,0,0,0
1123212,49,6,3,0,0,3,0,61
1123213,14,0,0,0,0,0,0,14
1123214,20,3,3,3,0,0,0,29
1123215,60,3,0,0,0,0,0,63
1123216,0,0,0,0,0,0,0,0
1123301,28,0,3,3,0,0,0,34
1123302,32,3,3,0,0,0,0,38
1123303,41,3,3,0,0,0,0,47
1123304,49,4,3,0,0,0,0,56
1123305,46,6,0,0,0,0,0,52
1123306,23,4,4,0,0,0,0,31
1123307,3,3,0,0,0,0,0,6
1123308,0,0,0,0,0,0,0,0
1123309,35,6,3,3,0,0,0,47
1123310,63,7,0,0,0,0,0,70
1123311,0,0,0,0,0,0,0,0
1123312,33,3,4,0,0,3,0,43
1123313,21,3,0,0,0,0,0,24
1123314,42,4,0,0,0,0,0,46
1123315,35,3,4,0,0,0,3,45
1123316,74,3,0,3,0,0,0,80
1123317,20,6,4,0,0,0,0,30
1123318,22,3,3,0,0,0,0,28
1123319,82,7,3,0,0,0,0,92
1123320,30,7,0,0,0,3,3,43
1123321,66,3,5,3,0,3,0,80
1123322,39,3,4,3,0,0,0,49
1123323,25,6,4,0,0,0,0,35
1123324,52,3,3,0,0,0,3,61
1123325,59,4,0,0,0,0,0,63
1123326,21,3,4,0,0,0,0,28
1123327,56,3,3,3,0,0,0,65
1123328,62,4,0,0,0,0,0,66
1123329,73,7,0,0,0,0,0,80
1123330,71,0,3,0,0,0,0,74
1123331,42,0,4,4,0,0,0,50
1123332,26,6,4,0,0,0,0,36
1123333,43,3,3,0,0,0,0,49
1123334,52,3,3,0,0,0,0,58
1123335,31,3,4,3,0,0,0,41
1123336,57,3,0,0,0,0,0,60
1123337,52,7,4,0,0,0,0,63
1123338,53,5,4,0,0,0,0,62
1123339,22,0,4,0,0,0,0,26
1123340,42,0,0,0,0,0,0,42
1123341,48,8,5,0,0,0,0,61
1123342,51,3,7,4,0,0,0,65
1123343,46,0,4,0,0,0,0,50
1123344,48,4,0,0,0,0,0,52
1123401,32,5,0,0,0,0,0,37
1123402,59,3,0,0,0,0,0,62
1123403,42,7,0,0,0,0,0,49
1123404,20,3,3,3,0,3,0,32
1123405,19,0,4,0,0,0,0,23
1123406,56,7,3,0,0,0,0,66
1123407,44,5,4,0,0,0,0,53
1123408,37,0,0,0,0,0,0,37
1123409,37,3,0,0,0,0,0,40
1123410,34,0,0,0,0,0,0,34
1123411,16,0,3,0,0,0,0,19
1123412,19,0,3,0,0,0,0,22
1123413,41,6,3,0,0,0,0,50
1123414,35,3,3,3,0,0,0,44
1123415,42,3,3,0,0,0,0,48
1123416,44,8,3,0,0,0,0,55
1123417,41,3,4,0,0,0,0,48
1123418,32,5,3,0,0,0,0,40
1123419,23,3,0,0,0,0,0,26
1123420,27,6,0,0,0,0,0,33
1123421,29,0,4,0,3,0,0,36
1123422,7,3,3,0,0,0,0,13
1123423,31,3,0,0,0,0,0,34
1123424,17,0,4,0,0,0,0,21
1123425,48,0,0,0,0,0,0,48
1123426,25,5,3,0,0,0,0,33
1123427,36,5,4,0,0,0,0,45
1123501,17,0,0,0,0,0,3,20
1123502,46,3,0,0,0,0,0,49
1123503,42,3,0,3,0,0,3,51
1123504,46,3,3,0,0,0,3,55
1123505,15,7,0,0,0,0,0,22
1123506,0,0,0,0,0,0,0,0
1123507,35,9,3,0,0,0,0,47
1123508,10,3,3,0,0,0,0,16
1123509,27,3,0,0,0,0,0,30
1123510,28,0,0,0,0,0,0,28
1123511,34,3,3,0,0,0,0,40
1123512,34,6,0,0,0,0,0,40
1123513,15,7,0,0,0,0,0,22
1123514,21,3,3,0,0,0,0,27
1123515,8,4,0,3,0,0,0,15
1123516,36,0,0,0,0,0,0,36
1123517,8,3,3,0,0,0,3,17
1123518,16,0,3,0,0,0,0,19
1123519,32,8,3,0,0,0,0,43
1123601,67,8,0,0,0,0,0,75
1123602,0,0,0,0,0,0,0,0
1123603,0,0,0,0,0,0,0,0
1123604,12,0,0,0,0,0,0,12
1123605,5,0,0,0,0,3,0,8
1123606,0,0,0,0,0,0,0,0
1123607,0,0,0,0,0,0,0,0
1123608,35,3,0,3,0,0,0,41
1123609,43,3,3,0,0,0,0,49
1123610,29,3,0,3,0,0,0,35
1123611,29,4,3,0,0,0,0,36
1123612,18,3,3,0,0,0,3,27
1123613,12,0,0,0,0,0,0,12
1123614,0,0,0,0,0,0,0,0
1123615,8,4,0,0,0,0,0,12
1123616,32,3,3,0,0,0,0,38
1123617,17,7,3,0,0,0,0,27
1123618,45,3,3,3,0,0,0,54
1123619,26,3,0,0,0,0,0,29
1123620,34,3,0,0,0,0,0,37
1123621,17,3,0,0,0,0,0,20
1123622,25,5,4,0,0,0,0,34
1123623,20,4,3,0,0,0,0,27
1123624,9,3,0,0,0,0,0,12
1123625,19,0,0,0,0,0,0,19
1123626,18,6,0,0,0,0,0,24
1123627,19,3,0,0,0,0,0,22
1123628,37,4,0,0,0,0,0,41
1123629,31,6,0,0,0,0,0,37
1123630,29,3,3,0,0,0,0,35
1123631,13,4,0,0,0,0,0,17
1123632,6,3,3,0,0,0,0,12
1123633,34,4,0,0,0,0,0,38
1123634,19,0,0,0,0,0,0,19
1123635,7,0,0,0,0,0,0,7
1123636,26,3,4,0,0,0,0,33
1123637,13,0,3,0,0,0,0,16
1123638,47,3,3,3,0,0,0,56
1123639,18,3,0,0,0,0,0,21
1123640,32,3,3,0,0,0,0,38
1123641,28,0,0,5,0,0,0,33
1123642,32,3,3,0,0,0,0,38
1123643,19,3,3,0,0,0,0,25
1123644,11,4,0,0,0,0,0,15
1123645,6,0,3,0,0,0,0,9
1123646,26,3,0,0,0,0,0,29
1123647,31,0,0,5,0,0,0,36
1123701,38,4,0,3,0,0,0,45
1123702,23,0,0,0,0,0,0,23
1123703,36,3,0,0,0,0,0,39
1123704,51,0,6,0,0,0,0,57
1123705,24,5,4,0,0,0,0,33
1123706,52,3,3,0,0,0,0,58
1123707,0,0,0,0,0,0,0,0
1123708,43,0,0,0,0,0,0,43
1123709,40,7,3,0,0,0,0,50
1123710,26,3,0,3,0,0,0,32
1123711,37,0,0,0,0,0,0,37
1123712,54,7,6,0,0,0,0,67
1123713,19,0,3,0,0,0,0,22
1123714,33,0,0,0,0,0,0,33
1123715,7,0,0,0,0,0,0,7
1123716,45,3,0,0,0,0,0,48
1123717,110,13,7,3,0,0,0,133
1123718,48,3,3,0,0,0,0,54
1123719,34,0,0,0,0,0,0,34
1123720,34,3,3,0,0,0,0,40
1123721,26,7,0,0,0,0,0,33
1123722,33,3,0,0,0,0,0,36
1123723,21,3,0,0,0,0,0,24
1123724,50,6,3,3,0,0,0,62
1123725,44,5,0,5,0,0,0,54
1123726,25,9,0,3,0,0,0,37
1123727,17,3,3,3,0,0,0,26
1123728,21,0,0,0,0,0,0,21
1123729,22,0,0,0,0,0,0,22
1123730,16,3,3,0,0,0,0,22
1123731,30,3,0,4,0,0,0,37
1123732,48,3,5,0,0,0,0,56
1123733,40,0,0,0,0,0,4,44
1123734,56,8,3,0,0,0,0,67
1123735,58,8,7,0,0,0,0,73
1123736,34,3,3,0,0,0,0,40
1123737,32,0,3,3,0,0,0,38
1123738,24,0,0,0,0,0,0,24
1123739,43,3,0,0,0,0,0,46
1123740,28,5,0,0,0,0,0,33
1123741,32,4,0,0,0,0,0,36
1123742,28,0,4,0,0,0,0,32
1123743,21,0,3,0,0,0,0,24
1123744,28,0,3,0,0,0,0,31
1123745,8,3,0,0,0,0,0,11
1123746,33,3,0,0,0,0,0,36
1123801,19,0,0,0,0,0,0,19
1123802,27,0,3,0,0,0,0,30
1123803,40,8,0,0,0,0,0,48
1123804,30,3,3,3,0,0,0,39
1123805,23,0,0,0,0,0,4,27
1123806,20,3,3,0,0,0,0,26
1123807,32,3,3,0,0,0,0,38
1123808,36,5,3,0,0,0,0,44
1123809,28,0,0,3,0,0,0,31
1123810,32,3,3,0,0,0,0,38
1123811,28,5,3,0,0,0,0,36
1123812,16,4,0,0,0,0,3,23
1123813,18,3,0,0,0,0,0,21
1123814,31,3,3,0,0,0,0,37
1123815,44,3,3,0,0,0,0,50
1123816,33,5,0,0,0,0,0,38
1123817,40,9,6,0,0,0,0,55
1123818,50,0,0,0,0,0,0,50
1123901,27,0,0,0,0,0,0,27
1123902,37,8,5,0,0,0,0,50
1123903,18,3,0,0,0,0,0,21
1123904,17,0,0,0,0,0,0,17
1123905,11,4,0,0,0,0,0,15
1123906,33,3,4,0,0,0,0,40
1123907,12,0,0,0,0,0,0,12
1123908,0,0,0,0,0,0,0,0
1123909,38,3,3,0,0,0,0,44
1123910,40,3,4,0,3,0,0,50
1123911,24,7,5,0,0,0,0,36
1123912,0,0,0,0,0,0,0,0
1123913,38,8,0,0,0,0,0,46
1123914,57,6,4,0,0,0,0,67
1123915,3,0,0,0,0,0,0,3
1123916,4,0,0,0,0,0,0,4
1123917,44,0,3,0,0,0,0,47
1123918,43,7,3,3,0,0,0,56
1123919,31,0,3,0,0,0,0,34
1123920,40,4,0,0,0,0,0,44
1123921,28,0,0,0,0,0,0,28
1123922,15,6,0,0,0,0,0,21
1123923,11,3,3,0,0,0,3,20
1123924,47,0,4,0,0,0,0,51
1123925,42,4,3,0,0,0,0,49
1124001,12,3,0,0,0,0,0,15
1124002,10,0,0,0,0,0,0,10
1124003,14,0,0,0,0,0,0,14
1124004,20,4,0,0,0,0,0,24
1124005,30,0,0,0,0,0,0,30
1124006,20,0,0,0,0,0,0,20
1124007,22,6,3,0,0,0,0,31
1124008,26,3,3,3,0,0,0,35
1124009,20,4,0,0,0,0,0,24
1124010,13,0,0,0,0,0,0,13
1124011,36,6,3,0,0,0,0,45
1124012,30,0,0,0,0,0,0,30
1124013,43,4,0,3,0,0,0,50
1124014,46,3,0,0,0,0,0,49
1124015,39,6,3,0,0,0,0,48
1124016,29,0,0,0,0,0,3,32
1124017,6,4,0,0,0,0,0,10
1124018,25,4,3,0,0,0,0,32
1124019,23,3,3,0,0,0,0,29
1124020,9,0,0,0,0,0,0,9
1124021,7,3,3,0,0,0,3,16
1124022,31,3,4,0,0,0,0,38
1124023,30,3,4,0,0,0,0,37
1124024,25,0,0,0,0,0,0,25
1124025,19,0,0,0,0,0,0,19
1124101,34,0,4,0,0,0,0,38
1124102,26,4,0,0,0,0,0,30
1124103,40,4,4,0,0,0,0,48
1124104,24,5,3,0,0,0,0,32
1124105,27,4,4,0,0,0,0,35
1124106,36,3,3,0,0,0,0,42
1124107,23,0,4,0,0,0,0,27
1124108,16,4,0,0,0,0,0,20
1124109,36,0,3,0,0,0,0,39
1124110,41,8,0,0,0,0,0,49
1124111,24,0,0,0,0,0,3,27
1124112,42,3,0,0,0,0,3,48
1124113,9,3,0,0,0,0,0,12
1124114,11,0,0,0,0,0,3,14
1124115,0,0,0,0,0,0,0,0
1124201,25,0,3,0,0,0,3,31
1124202,19,0,4,0,0,0,0,23
1124203,29,5,0,0,0,0,0,34
1124204,25,0,0,0,0,0,0,25
1124205,58,10,0,0,0,0,0,68
1124206,55,8,3,0,0,0,0,66
1124207,6,0,0,0,0,0,0,6
1124208,10,4,3,0,0,0,0,17
1124209,63,7,0,0,0,0,0,70
1124210,0,0,0,0,0,0,0,0
1124211,65,3,3,0,0,0,0,71
1124212,47,3,3,0,0,0,0,53
1124213,42,7,0,0,0,0,0,49
1124214,82,3,9,0,0,0,0,94
1124215,57,0,0,0,0,0,0,57
1124216,37,0,0,0,0,0,0,37
1124217,84,9,7,0,0,0,0,100
1124218,71,7,0,0,0,0,0,78
1124219,40,3,3,0,0,0,0,46
1124301,14,0,0,0,0,0,0,14
1124302,23,3,3,0,0,0,3,32
1124303,35,0,0,0,0,0,0,35
1124304,52,0,8,0,0,0,0,60
1124305,11,0,0,0,0,5,0,16
1124306,36,0,0,0,0,0,0,36
1124307,21,3,3,0,0,0,0,27
1124308,45,4,4,0,0,0,0,53
1124309,20,3,3,0,0,0,0,26
1124310,38,3,0,0,0,0,0,41
1124311,38,5,0,0,0,0,0,43
1124312,27,3,0,0,0,0,0,30
1124313,42,0,0,0,0,0,0,42
1124314,26,0,0,0,0,0,0,26
1124315,27,9,3,3,0,0,0,42
1124316,24,4,0,0,0,0,0,28
1124317,31,0,3,0,0,0,0,34
1124318,42,4,0,0,0,0,0,46
1124319,42,3,6,0,0,0,0,51
1124320,19,3,3,0,0,0,0,25
1124321,30,0,0,0,0,0,0,30
1124401,11,0,0,0,0,0,0,11
1124402,49,3,3,3,0,0,0,58
1124403,79,7,3,0,0,0,0,89
1124404,43,3,3,0,0,0,0,49
1124405,20,0,4,0,0,0,0,24
1124406,33,3,3,0,0,0,0,39
1124407,28,4,0,0,0,0,0,32
1124408,36,3,5,0,0,0,0,44
1124409,65,6,4,0,0,0,0,75
1124410,22,0,0,0,0,0,0,22
1124411,38,8,0,0,0,0,0,46
1124412,28,3,3,0,0,0,0,34
1124413,35,4,0,0,0,0,0,39
1124414,11,3,3,0,0,0,0,17
1124415,14,0,0,0,0,0,0,14
1124416,39,0,0,0,0,0,0,39
1124417,0,0,0,0,0,0,0,0
1124418,20,3,0,0,0,0,0,23
1124419,3,0,0,0,0,0,0,3
1124420,0,0,0,0,0,0,0,0
1124421,3,0,0,0,0,0,0,3
1124422,13,0,3,0,0,0,0,16
1124423,21,4,7,0,0,0,0,32
1124424,18,3,0,0,0,0,0,21
1124425,31,5,6,0,0,0,3,45
1124426,23,3,3,0,0,0,3,32
1124427,17,0,5,0,0,0,0,22
1124428,43,3,4,0,0,3,0,53
1124429,33,3,0,0,0,0,0,36
1124430,32,7,0,0,0,0,0,39
1124431,40,3,6,3,0,0,0,52
1124432,31,3,3,0,0,0,3,40
1124433,12,0,5,0,0,0,0,17
1124434,24,0,5,0,0,0,0,29
1124435,26,0,4,0,0,0,0,30
1124501,11,3,3,0,0,0,0,17
1124502,10,0,0,0,0,0,0,10
1124503,29,0,5,0,0,0,0,34
1124504,28,5,7,0,0,0,3,43
1124505,14,3,5,0,0,0,0,22
1124506,8,3,0,0,0,0,3,14
1124507,23,3,0,0,0,0,0,26
1124508,18,0,6,0,0,0,0,24
1124509,17,4,0,0,0,0,0,21
1124510,19,0,0,0,0,0,0,19
1124511,13,0,0,0,0,0,0,13
1124512,33,3,3,3,0,0,0,42
1124513,27,5,0,0,0,0,0,32
1124514,30,4,0,0,0,0,0,34
1124515,13,0,0,0,0,3,0,16
1124516,40,5,0,5,0,0,0,50
1124517,44,3,3,0,0,0,3,53
1124518,16,0,0,0,0,0,0,16
1124519,21,3,3,0,0,0,0,27
1124520,22,0,3,0,0,0,0,25
1124521,12,3,6,3,0,0,0,24
1124522,22,3,0,3,0,0,0,28
1124523,25,4,3,0,0,0,3,35
1124524,32,3,0,0,0,0,0,35
1124525,27,3,3,0,0,0,0,33
1124526,25,3,0,0,0,0,3,31
1124527,17,0,0,0,0,0,3,20
1124528,21,3,0,0,0,0,0,24
1124601,26,0,0,0,0,0,0,26
1124602,18,0,0,0,0,0,0,18
1124603,35,6,0,0,0,0,0,41
1124604,49,3,3,0,0,0,0,55
1124605,32,3,3,0,0,0,0,38
1124606,39,4,0,0,0,0,0,43
1124607,46,5,4,0,0,0,0,55
1124608,42,10,0,0,0,0,4,56
1124609,22,3,4,0,0,0,0,29
1124610,43,5,4,4,0,0,0,56
1124611,17,3,3,4,0,0,0,27
1124612,13,0,5,3,0,0,3,24
1124613,27,6,4,0,0,0,0,37
1124614,41,4,6,0,0,0,0,51
1124615,19,3,0,0,0,0,0,22
1124616,38,3,3,3,0,0,0,47
1124617,39,3,0,0,0,0,0,42
1124618,47,4,4,0,0,0,0,55
1124619,20,5,3,0,0,0,0,28
1124620,37,0,5,0,0,0,0,42
1124621,21,4,0,0,0,0,0,25
1124622,33,0,4,0,0,0,0,37
1124623,27,3,0,0,0,0,0,30
1124624,53,4,3,0,0,0,0,60
1124625,16,0,3,0,0,0,0,19
1124626,26,0,0,0,0,0,0,26
1124627,19,3,7,0,0,0,0,29
1124628,25,0,0,4,0,0,0,29
1124629,37,5,3,0,0,0,5,50
1124630,53,3,3,0,0,0,0,59
1124631,14,3,0,0,0,0,0,17
1124632,35,4,0,0,0,0,0,39
1124633,15,3,3,0,0,0,3,24
1124634,21,0,3,0,0,0,0,24
1124701,12,3,0,0,0,0,0,15
1124702,13,3,0,0,0,0,0,16
1124703,52,6,3,0,0,0,0,61
1124704,17,4,0,0,0,0,0,21
1124705,28,5,3,0,0,0,0,36
1124706,25,0,0,0,0,0,0,25
1124707,42,0,0,0,0,0,3,45
1124708,20,0,0,0,0,0,0,20
1124709,21,0,0,3,0,0,0,24
1124710,12,3,0,0,0,0,0,15
1124711,48,0,4,0,0,0,0,52
1124712,15,0,0,4,0,0,0,19
1124713,23,0,0,0,3,0,0,26
1124714,39,7,5,0,0,0,3,54
1124715,45,4,3,0,0,0,0,52
1124716,17,3,0,0,0,0,3,23
1124717,13,0,3,0,0,0,0,16
1124718,19,4,3,0,0,0,0,26
1124719,26,3,7,0,0,0,3,39
1124720,29,3,3,0,0,0,0,35
1124721,28,3,0,0,0,0,3,34
1124722,22,0,0,0,0,0,0,22
1124723,18,3,0,0,0,0,0,21
1124724,22,0,3,0,0,0,0,25
1124725,23,3,4,0,0,0,0,30
1124801,7,0,0,0,0,0,0,7
1124802,17,3,0,3,0,0,0,23
1124803,46,3,3,0,0,0,0,52
1124804,19,3,3,0,0,0,0,25
1124805,35,10,3,0,0,0,0,48
1124806,33,5,4,0,0,0,0,42
1124807,22,0,0,0,0,0,3,25
1124808,38,5,3,0,0,0,3,49
1124809,16,3,3,0,0,0,0,22
1124810,45,3,5,0,0,0,0,53
1124811,47,4,3,0,0,0,0,54
1124812,37,3,3,0,0,0,0,43
1124813,12,3,3,0,0,0,0,18
1124814,19,0,4,0,0,3,0,26
1124815,33,7,9,0,0,3,0,52
1124816,49,5,3,0,0,0,0,57
1124817,16,3,0,0,0,0,0,19
1124818,48,6,7,3,0,0,0,64
1124819,22,7,3,0,0,0,0,32
1124820,22,5,0,0,0,0,0,27
1124821,36,3,3,0,0,0,0,42
1124822,8,0,0,0,0,0,0,8
1124823,60,5,0,0,0,0,0,65
1124824,45,0,3,0,0,0,0,48
1124825,36,6,3,0,0,0,0,45
1124826,34,0,0,0,0,0,0,34
1124827,21,0,3,0,0,0,0,24
1124828,28,3,3,0,0,0,0,34
1124829,27,4,0,0,0,0,0,31
1124830,46,4,3,3,0,0,0,56
1124831,8,3,3,0,0,0,0,14
1124832,21,4,0,0,0,0,0,25
1124833,29,3,0,0,0,0,0,32
1124834,11,3,0,0,0,0,0,14
1124835,16,0,3,0,0,0,0,19
1124836,17,4,0,0,0,0,0,21
1124837,34,8,0,0,0,0,0,42
1124838,10,0,0,0,0,0,0,10
1124839,13,5,0,0,0,0,0,18
1124840,27,0,0,0,0,0,0,27
1124901,75,0,3,3,0,0,0,81
1124902,23,8,0,0,0,0,0,31
1124903,22,0,3,0,0,0,0,25
1124904,42,4,3,0,0,0,0,49
1124905,30,0,3,0,0,0,0,33
1124906,33,5,0,0,0,0,0,38
1124907,15,4,0,0,0,0,0,19
1124908,50,0,0,0,0,0,0,50
1124909,42,0,4,0,0,0,0,46
1124910,63,3,0,0,0,0,3,69
1124911,61,5,3,0,0,0,0,69
1124912,81,5,0,0,0,0,0,86
1124913,27,3,6,0,0,0,4,40
1124914,34,4,0,0,0,0,0,38
1124915,37,0,4,0,0,0,0,41
1124916,43,0,4,0,0,0,0,47
1124917,44,3,0,0,0,0,0,47
1124918,17,5,0,0,0,0,0,22
1124919,53,8,3,0,0,0,0,64
1124920,31,0,0,0,0,0,0,31
1124921,38,3,3,0,0,0,3,47
1124922,67,7,0,0,0,0,0,74
1124923,22,3,3,0,0,0,0,28
1124924,49,5,0,0,0,0,0,54
1124925,35,0,3,0,0,0,0,38
1124926,41,3,6,0,0,0,0,50
1124927,30,3,0,0,0,0,0,33
1124928,0,0,0,0,0,0,0,0
1124929,13,5,0,0,0,0,0,18
1124930,14,3,3,0,0,0,0,20
1124931,21,0,0,0,0,0,0,21
1124932,12,0,0,0,0,0,0,12
1124933,41,3,4,0,0,0,0,48
1124934,24,0,4,0,0,0,0,28
1124935,25,0,0,0,0,0,0,25
1124936,23,5,3,0,0,0,0,31
1124937,28,3,0,0,0,0,0,31
1124938,27,4,3,0,0,0,0,34
1124939,33,3,0,0,0,0,0,36
1124940,26,3,0,0,0,0,0,29
1124941,19,5,0,0,0,0,0,24
1124942,53,0,5,0,0,0,0,58
1124943,35,4,3,0,0,0,0,42
1124944,29,3,0,0,0,0,0,32
1125001,54,3,3,0,0,0,0,60
1125002,102,6,0,0,0,0,0,108
1125003,104,5,0,0,0,0,0,109
1125004,130,11,4,0,0,0,0,145
1125005,50,5,5,0,0,0,0,60
1125006,28,8,4,0,0,0,0,40
1125007,34,4,0,0,0,0,0,38
1125008,27,3,0,0,0,0,0,30
1125009,63,0,3,0,0,0,4,70
1125010,0,0,0,0,0,0,0,0
1125011,40,0,7,0,0,0,0,47
1125012,43,6,0,0,0,0,0,49
1125013,30,6,4,0,0,0,0,40
1125014,3,0,0,0,0,0,0,3
1125015,36,0,7,4,0,0,0,47
1125016,31,5,0,0,0,0,0,36
1125017,42,7,0,0,0,0,0,49
1125018,7,3,0,0,0,0,0,10
1125019,6,0,0,0,0,0,0,6
1125020,36,3,3,0,0,0,0,42
1125021,23,6,4,4,0,0,0,37
1125022,39,0,4,0,0,0,3,46
1125101,31,3,6,0,0,0,0,40
1125102,24,3,3,0,0,0,3,33
1125103,45,6,4,0,0,0,0,55
1125104,18,3,0,0,0,0,0,21
1125105,45,5,3,3,0,0,0,56
1125106,11,0,3,3,0,0,0,17
1125107,27,4,3,4,0,0,0,38
1125108,58,3,3,0,0,0,0,64
1125109,3,0,0,0,0,0,0,3
1125110,0,3,0,0,0,0,0,3
1125111,24,5,0,0,0,0,0,29
1125112,21,7,0,0,0,0,0,28
1125113,36,3,5,0,0,0,0,44
1125114,28,3,3,0,0,0,0,34
1125115,82,11,3,0,0,0,0,96
1125116,3,0,0,0,0,0,0,3
1125117,30,3,0,0,0,0,0,33
1125118,0,0,0,0,0,0,0,0
1125119,32,3,3,3,0,0,0,41
1125120,30,9,3,0,0,0,3,45
1125121,30,4,4,0,0,0,4,42
1125122,54,3,0,3,0,0,0,60
1125123,24,4,4,0,0,0,0,32
1125201,29,0,5,3,0,0,0,37
1125202,17,3,0,0,0,0,0,20
1125203,36,3,0,3,0,0,3,45
1125204,21,3,3,0,0,0,0,27
1125205,28,3,3,0,0,0,0,34
1125206,44,8,0,0,0,0,0,52
1125207,13,3,3,0,0,0,0,19
1125208,23,3,0,0,3,0,0,29
1125209,20,5,0,0,0,0,0,25
1125210,27,3,3,0,0,0,0,33
1125211,22,4,0,0,0,0,0,26
1125212,42,3,3,3,0,0,3,54
1125213,26,0,0,0,0,0,3,29
1125214,39,0,0,0,0,0,0,39
1125215,15,0,0,4,0,0,0,19
1125216,17,0,3,0,0,0,0,20
1125217,22,4,0,0,0,0,0,26
1125218,23,0,5,0,0,0,0,28
1125219,20,8,3,0,0,0,0,31
1125220,30,0,0,3,0,0,0,33
1125221,26,3,0,0,0,0,0,29
1125222,37,4,0,0,0,0,0,41
1125223,17,3,0,0,0,0,0,20
1125224,33,0,3,3,0,0,0,39
1125225,26,7,0,0,0,0,0,33
1125226,25,0,7,3,0,0,0,35
1125227,39,3,3,0,0,0,0,45
1125228,27,0,0,0,0,0,0,27
1125229,59,6,4,0,0,0,0,69
1125230,14,4,0,0,0,0,0,18
1125231,20,3,0,0,0,0,0,23
1125232,21,3,3,0,0,0,3,30
1125301,32,7,0,0,0,0,4,43
1125302,40,3,0,0,0,0,3,46
1125303,31,6,0,0,0,0,0,37
1125304,15,0,3,0,0,0,0,18
1125305,68,3,3,0,0,0,0,74
1125306,27,0,0,0,0,0,0,27
1125307,24,3,0,0,0,0,0,27
1125308,92,5,10,0,0,0,0,107
1125309,102,6,7,0,0,0,0,115
1125310,42,4,0,0,0,0,0,46
1125311,35,3,3,3,0,0,3,47
1125312,49,7,0,3,0,0,0,59
1125313,35,5,0,0,0,0,0,40
1125314,39,4,4,0,0,0,0,47
1125315,45,3,3,0,0,0,0,51
1125316,58,3,3,3,0,0,0,67
1125317,31,4,0,0,0,0,0,35
1125318,40,7,6,0,0,0,0,53
1125319,0,0,0,0,0,0,0,0
1125320,17,4,0,0,0,0,0,21
1125321,28,3,0,3,0,0,0,34
1125322,28,0,0,0,0,0,0,28
1125323,59,8,5,0,0,0,0,72
1125324,0,0,0,0,0,0,0,0
1125325,52,4,4,0,0,0,0,60
1125326,29,3,0,0,0,0,0,32
1125327,43,4,3,0,0,0,0,50
1125328,46,5,7,0,0,0,0,58
1125329,61,3,4,0,0,0,0,68
1125401,12,3,0,0,0,0,0,15
1125402,6,0,0,0,0,0,0,6
1125403,0,0,0,0,0,0,0,0
1125404,3,0,0,0,0,0,0,3
1125405,8,0,0,0,0,0,4,12
1125406,38,0,0,0,0,0,0,38
1125407,35,4,3,3,0,0,0,45
1125408,35,3,3,0,0,0,0,41
1125409,17,3,3,0,0,0,0,23
1125410,13,4,0,0,0,0,0,17
1125411,16,3,0,0,0,0,0,19
1125412,9,3,0,0,0,0,0,12
1125413,19,3,0,0,0,0,0,22
1125414,26,0,3,0,0,0,0,29
1125415,34,5,3,0,0,0,0,42
1125416,11,0,0,0,0,0,0,11
1125417,22,4,0,0,0,0,3,29
1125418,33,3,6,0,0,0,4,46
1125419,33,7,0,0,0,0,0,40
1125420,29,4,3,0,0,0,0,36
1125421,16,3,0,0,0,0,0,19
1125422,61,3,0,3,0,0,0,67
1125423,37,3,3,0,0,0,0,43
1125424,41,3,3,0,0,0,4,51
1125425,41,9,0,0,0,0,0,50
1125426,31,8,3,3,0,0,0,45
1125427,27,4,4,3,0,0,0,38
1125428,30,3,3,0,0,0,0,36
1125429,43,0,4,0,0,0,0,47
1125430,21,5,0,0,0,0,0,26
1125431,24,5,0,0,0,0,0,29
1125432,37,8,0,0,0,0,0,45
1125433,30,8,0,0,0,0,0,38
1125434,33,5,0,0,0,0,0,38
1125435,62,3,5,3,0,0,3,76
1125436,15,0,0,0,0,0,0,15
1125437,5,0,0,0,0,0,0,5
1125438,10,3,5,0,0,0,0,18
1125439,29,4,0,3,0,0,0,36
1125440,58,5,8,0,0,0,0,71
1125441,0,0,0,0,0,0,0,0
1125442,14,3,0,0,0,0,0,17
1125443,22,0,0,0,0,0,0,22
1125444,60,4,3,0,0,0,0,67
1125445,31,3,0,0,0,3,0,37
1125446,55,4,0,0,0,0,0,59
1125447,13,0,4,0,0,0,0,17
1125501,53,7,5,0,0,0,0,65
1125502,53,3,3,0,0,0,0,59
1125503,46,0,5,0,0,0,0,51
1125504,12,5,5,0,0,0,0,22
1125505,0,0,0,0,0,0,0,0
1125506,25,5,3,0,0,3,0,36
1125507,46,4,4,0,0,0,0,54
1125508,48,4,8,0,0,0,0,60
1125509,20,0,0,3,0,0,0,23
1125510,35,7,0,0,0,0,0,42
1125511,40,8,3,0,0,0,0,51
1125512,30,7,0,3,0,0,0,40
1125513,17,0,3,0,0,0,5,25
1125514,5,0,0,0,0,0,0,5
1125515,24,3,3,0,0,0,0,30
1125516,55,5,7,3,0,0,0,70
1125517,17,3,0,0,0,0,0,20
1125518,27,4,3,0,0,0,0,34
1125519,11,0,4,0,0,0,0,15
1125520,17,0,0,0,0,0,0,17
1125521,49,4,3,0,0,0,0,56
1125522,9,0,0,0,0,0,0,9
1125523,0,0,0,0,0,0,0,0
1125524,52,9,0,3,0,0,0,64
1125525,13,0,0,0,0,0,0,13
1125526,19,3,0,0,0,0,0,22
1125527,27,3,0,3,0,0,0,33
1125528,33,5,3,0,0,0,0,41
1125529,19,0,0,0,0,0,0,19
1125530,47,10,6,0,0,0,0,63
1125531,62,3,10,0,0,0,3,78
1125532,45,3,6,0,0,0,0,54
1125533,33,0,0,3,0,0,0,36
1125534,37,4,3,0,0,0,0,44
1125535,0,0,0,0,0,0,0,0
1125536,35,5,4,0,0,0,0,44
1125537,6,0,0,0,0,0,0,6
1125538,34,3,0,0,0,0,0,37
1125539,54,3,3,0,0,0,0,60
1125540,7,0,0,0,0,0,0,7
1125541,0,0,0,0,0,0,0,0
1125542,57,6,0,0,0,0,0,63
1125543,53,3,3,0,0,0,0,59
1125544,7,5,0,0,0,0,0,12
1125545,11,8,3,0,0,0,0,22
1125546,27,4,3,0,0,0,0,34
1125547,28,4,3,0,0,0,0,35
1125548,31,4,5,0,3,0,0,43
1125549,22,3,0,0,0,0,0,25
1125550,42,3,3,0,0,0,0,48
1125551,35,3,0,0,0,0,0,38
1125552,30,3,0,0,0,0,0,33
1125553,71,6,0,0,0,0,0,77
1125554,74,3,7,0,0,0,0,84
1125555,25,0,0,0,0,0,4,29
1125556,27,13,4,0,0,0,0,44
1125557,42,5,0,0,0,0,0,47
1125558,21,5,0,0,0,0,0,26
1125559,15,3,0,0,0,0,0,18
1125560,35,3,6,0,0,0,3,47
1125561,5,0,0,0,0,0,0,5
1125562,24,6,0,0,0,0,0,30
1125563,11,0,0,0,0,0,0,11
1125564,48,0,3,3,0,0,3,57
1125565,26,0,0,3,0,0,0,29
1125566,51,3,3,0,0,0,0,57
1125567,53,8,3,0,0,0,0,64
1125601,31,4,0,0,0,0,0,35
1125602,27,0,3,0,0,0,0,30
1125603,12,0,0,0,0,0,0,12
1125604,18,0,0,3,0,0,0,21
1125605,13,0,3,0,0,0,0,16
1125606,55,0,0,0,0,0,0,55
1125607,61,7,3,0,0,0,0,71
1125608,73,4,3,0,0,0,0,80
1125609,45,0,0,0,0,0,0,45
1125610,23,0,0,0,0,0,0,23
1125611,24,4,0,0,0,0,0,28
1125612,27,0,0,0,0,0,0,27
1125613,50,4,5,0,0,0,0,59
1125614,70,3,0,0,0,0,0,73
1125615,36,0,0,0,0,3,3,42
1125616,84,9,0,0,0,0,0,93
1125617,49,3,0,4,0,0,0,56
1125618,3,0,0,0,0,0,0,3
1125619,48,5,0,0,0,0,0,53
1125620,63,5,0,0,0,0,0,68
1125621,46,4,3,0,0,0,0,53
1125622,47,3,0,3,0,0,0,53
1125623,42,0,3,0,0,0,0,45
1125624,38,6,10,0,0,0,0,54
1125625,45,8,0,0,0,0,0,53
1125626,30,0,5,0,0,0,0,35
1125627,52,0,0,0,0,0,3,55
1125628,41,3,0,0,0,0,3,47
1125629,94,7,3,0,0,0,0,104
1125630,62,3,3,0,0,0,0,68
1125631,21,0,0,0,0,0,0,21
1125632,32,4,0,0,0,0,0,36
1125633,24,4,0,0,0,0,0,28
1125634,62,3,0,0,0,0,0,65
1125635,43,0,0,0,0,0,0,43
1125636,30,3,3,0,0,0,0,36
1125637,61,4,3,0,0,0,0,68
1125638,33,3,3,3,0,0,0,42
1125639,32,0,3,0,0,0,3,38
1125640,34,3,0,0,0,0,0,37
1125641,10,0,0,0,0,0,0,10
1125642,57,4,3,0,0,0,0,64
1125643,34,0,0,3,0,0,0,37
1125644,22,0,7,3,0,0,3,35
1125645,33,4,3,0,0,0,0,40
1125701,38,0,0,0,0,0,0,38
1125702,20,0,0,0,0,0,0,20
1125703,64,0,3,0,0,0,0,67
1125704,36,3,3,0,0,0,0,42
1125705,17,0,0,0,0,0,0,17
1125706,22,3,0,0,0,0,0,25
1125707,50,0,4,0,0,0,0,54
1125708,36,4,0,0,0,0,0,40
1125709,64,0,3,0,0,0,0,67
1125710,47,3,0,0,0,0,0,50
1125711,52,3,0,3,0,0,0,58
1125712,71,3,0,0,0,0,0,74
1125713,29,0,0,0,0,0,0,29
1125714,36,0,0,0,0,0,0,36
1125715,34,3,3,0,0,0,0,40
1125716,28,4,0,0,0,0,0,32
1125717,34,3,0,0,0,0,0,37
1125718,22,3,3,0,0,0,0,28
1125719,15,0,3,0,0,0,0,18
1125720,32,0,0,0,0,0,0,32
1125721,44,4,0,0,0,0,0,48
1125722,57,3,3,0,0,0,0,63
1125723,53,3,4,0,0,0,0,60
1125724,34,0,0,0,0,0,0,34
1125725,28,3,3,0,0,0,0,34
1125726,57,4,4,0,0,0,0,65
1125727,29,8,0,0,0,0,0,37
1125728,40,3,3,0,0,0,0,46
1125729,28,0,0,0,0,0,0,28
1125730,32,4,7,0,0,0,0,43
1125731,12,0,0,0,0,0,0,12
1125732,43,6,5,0,0,0,0,54
1125733,17,5,3,0,0,0,0,25
1125734,28,0,4,0,0,0,0,32
1125735,24,4,0,4,0,0,0,32
1125736,27,0,0,0,0,0,0,27
1125737,20,0,5,0,0,0,0,25
1125738,37,5,0,0,0,0,0,42
1125739,0,0,0,0,0,0,0,0
1125740,27,3,4,0,0,0,0,34
1125741,50,3,3,3,0,0,3,62
1125742,21,0,0,0,0,0,0,21
1125801,21,3,0,0,0,0,0,24
1125802,37,4,10,0,0,0,0,51
1125803,0,0,0,0,0,0,0,0
1125804,22,3,0,0,0,0,0,25
1125805,19,0,3,0,0,0,0,22
1125806,0,0,0,0,0,0,0,0
1125807,33,3,3,0,0,0,0,39
1125808,18,0,0,0,0,0,0,18
1125809,25,3,3,0,0,3,0,34
1125810,52,0,0,0,0,0,0,52
1125811,26,3,0,0,0,0,0,29
1125812,11,0,0,0,0,0,0,11
1125813,44,0,0,0,0,0,0,44
1125814,36,3,0,3,0,0,0,42
1125815,25,3,0,0,0,3,3,34
1125816,22,0,8,0,0,0,0,30
1125817,38,3,0,0,0,0,0,41
1125818,53,0,3,0,0,0,0,56
1125819,15,0,0,5,0,0,0,20
1125820,33,3,4,0,0,0,0,40
1125821,63,4,0,0,0,0,0,67
1125822,33,4,0,3,0,0,0,40
1125823,25,3,0,0,0,0,3,31
1125824,26,0,3,0,0,0,0,29
1125825,22,0,5,0,0,0,0,27
1125826,43,3,3,0,0,0,0,49
1125827,67,0,0,0,0,0,0,67
1125828,24,3,3,0,0,0,0,30
1125829,50,5,5,0,0,0,0,60
1125830,8,0,0,0,0,0,0,8
1125831,23,0,0,0,0,0,0,23
1125901,17,0,0,0,0,0,0,17
1125902,30,0,0,0,0,0,0,30
1125903,33,0,0,0,0,0,0,33
1125904,14,0,0,0,0,0,0,14
1125905,31,3,3,3,0,0,0,40
1125906,9,0,3,0,0,0,0,12
1125907,35,0,6,0,0,0,0,41
1125908,28,3,3,0,0,0,0,34
1125909,41,3,5,0,0,0,0,49
1125910,46,3,0,0,0,0,3,52
1125911,25,3,3,0,0,0,0,31
1125912,19,3,0,0,0,0,0,22
1125913,17,3,3,0,0,0,0,23
1125914,17,0,0,0,0,0,0,17
1125915,16,0,3,0,0,0,0,19
1125916,24,0,0,0,0,0,0,24
1125917,21,0,3,0,0,0,0,24
1125918,11,3,3,0,0,0,3,20
1125919,21,0,3,0,0,0,3,27
1125920,0,0,0,0,0,0,0,0
1125921,19,3,0,0,0,0,0,22
1125922,46,6,0,0,0,0,0,52
1126001,41,3,3,0,0,0,0,47
1126002,46,0,0,0,0,0,0,46
1126003,33,3,0,0,0,0,0,36
1126004,12,0,4,0,0,0,0,16
1126005,15,0,5,0,0,0,0,20
1126006,23,0,0,0,0,0,0,23
1126007,16,5,0,3,0,0,0,24
1126008,0,0,0,0,0,0,0,0
1126009,24,4,0,0,0,0,0,28
1126010,0,0,0,0,0,0,0,0
1126011,0,0,0,0,0,0,0,0
1126012,30,6,0,0,0,0,0,36
1126013,27,3,0,0,0,0,0,30
1126014,9,3,0,0,0,0,0,12
1126101,37,0,0,0,0,0,0,37
1126102,52,6,0,0,0,3,0,61
1126103,52,5,4,3,0,0,0,64
1126104,29,10,0,0,0,0,0,39
1126105,43,7,0,0,0,3,0,53
1126106,45,0,0,0,0,0,0,45
1126107,16,3,4,0,0,0,0,23
1126108,41,0,0,0,0,0,0,41
1126109,17,6,0,0,0,0,0,23
1126110,20,0,3,0,0,0,0,23
1126111,33,0,5,0,3,0,0,41
1126112,47,3,3,3,0,0,0,56
1126113,39,3,3,0,0,0,0,45
1126114,15,0,3,0,0,0,0,18
1126115,39,6,0,0,0,0,0,45
1126116,26,4,6,0,0,0,0,36
1126117,12,3,3,0,0,0,0,18
1126118,20,0,0,0,0,0,0,20
1126119,0,0,0,0,0,0,0,0
1126120,8,0,0,0,0,0,0,8
1126201,17,3,0,0,0,0,0,20
1126202,9,0,0,0,0,0,0,9
1126203,31,0,5,0,0,0,0,36
1126204,19,4,0,0,0,0,0,23
1126205,46,3,0,0,0,0,0,49
1126206,42,0,3,0,0,0,0,45
1126207,14,3,0,0,0,0,0,17
1126208,42,3,0,0,0,0,0,45
1126209,11,5,0,0,0,0,0,16
1126210,29,3,0,0,0,0,0,32
1126211,38,3,3,0,0,0,0,44
1126212,49,7,0,4,0,0,3,63
1126213,24,0,3,0,0,0,0,27
1126214,41,0,4,0,0,0,0,45
1126215,24,3,6,0,0,0,0,33
1126216,24,3,5,0,0,0,3,35
1126301,52,4,4,0,0,0,4,64
1126302,25,6,0,0,0,0,0,31
1126303,17,0,3,0,0,0,0,20
1126304,21,3,4,0,0,0,3,31
1126305,33,3,3,0,0,0,0,39
1126306,25,4,0,0,0,0,0,29
1126307,20,0,0,0,0,0,4,24
1126308,29,3,3,0,0,0,3,38
1126309,42,3,0,0,0,0,0,45
1126310,21,3,0,0,0,0,0,24
1126311,65,0,0,0,0,0,0,65
1126312,35,0,3,0,0,0,0,38
1126313,38,3,0,0,3,0,3,47
1126314,16,5,0,0,0,0,0,21
1126315,26,0,4,3,0,0,0,33
1126316,19,5,0,0,0,0,0,24
1126317,28,3,0,3,0,0,0,34
1126318,21,3,4,0,0,0,0,28
1126319,40,6,0,0,0,0,3,49
1126320,19,4,3,0,0,0,0,26
1126321,20,0,0,0,0,0,0,20
1126322,0,0,0,0,0,0,0,0
1126401,40,3,3,0,0,0,0,46
1126402,31,3,0,0,0,0,0,34
1126403,16,3,3,0,0,0,0,22
1126404,27,6,0,0,0,0,0,33
1126405,16,3,0,0,0,0,0,19
1126406,43,3,6,0,0,0,0,52
1126407,36,4,0,4,0,0,0,44
1126408,45,8,3,0,0,0,0,56
1126409,42,3,0,0,0,0,0,45
1126410,32,7,0,0,0,0,0,39
1126411,24,0,0,0,0,0,0,24
1126501,34,3,3,0,0,0,0,40
1126502,20,3,3,0,0,0,0,26
1126503,22,3,3,3,0,0,0,31
1126504,23,3,3,0,0,0,3,32
1126505,36,5,7,3,0,0,0,51
1126506,38,4,9,0,0,0,0,51
1126507,24,0,3,0,0,0,4,31
1126508,0,0,0,0,0,0,0,0
1126509,3,0,0,0,0,0,0,3
1126510,45,3,3,4,0,0,0,55
1126511,27,3,3,0,0,0,0,33
1126512,35,6,6,0,0,0,0,47
1126513,24,0,0,0,0,0,0,24
1126514,56,3,3,0,0,0,0,62
1126515,49,4,3,0,0,0,0,56
1126516,32,0,3,0,0,0,0,35
1126517,0,0,0,0,0,0,0,0
1126601,0,0,0,0,0,0,0,0
1126602,12,8,0,0,0,0,0,20
1126603,20,0,3,0,0,0,0,23
1126604,24,5,5,0,0,0,0,34
1126605,23,0,0,0,0,0,0,23
1126606,32,0,0,0,0,0,0,32
1126607,39,0,0,0,0,0,0,39
1126608,33,5,0,0,0,0,0,38
1126609,19,3,0,0,0,0,0,22
1126610,15,0,0,0,0,0,0,15
1126611,10,4,0,0,0,0,0,14
1126612,39,3,3,0,0,0,0,45
1126613,26,0,0,0,0,0,0,26
1126614,21,3,0,3,0,0,0,27
1126615,36,3,0,0,0,0,0,39
1126616,36,0,3,0,0,0,0,39
1126617,45,0,4,0,0,0,0,49
1126618,42,0,0,0,0,0,0,42
1126619,54,0,3,0,0,0,0,57
1126620,19,3,3,3,0,0,0,28
1126621,25,0,0,0,0,0,0,25
1126622,11,0,4,0,0,0,0,15
1126701,29,0,0,0,0,0,0,29
1126702,35,7,3,0,0,0,0,45
1126703,37,6,0,0,3,0,0,46
1126704,38,9,0,0,0,0,0,47
1126705,15,5,0,0,0,0,0,20
1126706,0,0,0,0,0,0,0,0
1126707,24,3,6,0,0,0,0,33
1126708,35,0,3,0,0,0,0,38
1126709,60,3,0,0,0,0,0,63
1126710,44,4,3,0,0,0,0,51
1126711,57,0,3,0,0,0,0,60
1126712,47,4,0,0,0,0,3,54
1126713,15,3,3,3,0,0,0,24
1126714,66,0,3,4,0,0,0,73
1126715,56,3,0,0,0,0,0,59
1126716,21,3,3,0,0,0,0,27
1126717,39,3,3,0,0,0,0,45
1126718,48,5,0,0,0,3,0,56
1126719,50,8,3,0,0,0,0,61
1126720,39,0,0,0,0,0,0,39
1126721,50,4,3,0,0,0,0,57
1126722,32,0,3,0,0,0,0,35
1126723,33,3,3,0,0,0,0,39
1126724,24,3,3,0,0,0,0,30
1126725,60,3,3,0,0,0,0,66
1126726,21,0,0,0,0,0,0,21
1126727,28,4,0,0,0,0,3,35
1126728,22,7,0,0,0,0,0,29
1126729,27,8,4,0,0,0,0,39
1126730,16,0,4,0,0,0,0,20
1126731,29,3,3,0,0,0,0,35
1126732,45,6,3,0,0,0,0,54
1126733,23,0,7,0,0,0,0,30
1126734,22,0,8,0,0,0,0,30
1126735,24,0,0,0,0,0,0,24
1126736,46,4,3,0,0,0,0,53
1126737,56,3,3,0,0,0,0,62
1126738,47,3,4,0,0,0,0,54
1126739,98,4,4,0,0,0,0,106
1126740,23,3,0,0,0,0,3,29
1126741,56,0,0,0,0,0,0,56
1126742,22,3,0,0,0,0,0,25
1126743,34,4,4,0,0,0,0,42
1126801,51,3,4,0,0,0,0,58
1126802,31,0,0,0,0,0,0,31
1126803,34,0,0,0,0,0,0,34
1126804,40,5,0,0,0,0,0,45
1126805,26,0,0,0,0,0,0,26
1126806,18,0,3,0,0,0,0,21
1126807,9,0,0,0,0,0,0,9
1126808,0,0,0,0,0,0,0,0
1126809,53,10,5,0,0,0,0,68
1126810,21,4,0,0,0,0,0,25
1126811,4,0,0,0,0,0,0,4
1126812,18,0,0,0,0,0,0,18
1126901,126,5,9,0,0,0,0,140
1126902,71,5,0,0,0,0,3,79
1126903,52,0,0,0,0,0,0,52
1126904,51,7,0,0,0,0,0,58
1126905,134,13,8,0,0,0,0,155
1126906,90,5,7,0,0,0,0,102
1126907,29,0,3,0,0,0,0,32
1126908,0,0,0,0,0,0,0,0
1126909,0,0,0,0,0,0,0,0
1126910,72,10,4,0,0,0,0,86
1126911,77,3,0,0,0,0,0,80
1126912,78,0,0,3,0,0,0,81
1126913,32,3,6,0,0,0,0,41
1126914,24,0,0,0,0,0,0,24
1126915,30,0,0,0,0,0,0,30
1126916,49,4,0,0,0,0,0,53
1126917,33,3,0,0,0,0,0,36
1126918,110,8,3,0,0,0,0,121
1126919,110,5,8,0,0,0,0,123
1126920,60,3,3,3,0,0,0,69
1126921,22,6,0,5,0,0,0,33
1126922,42,3,6,0,0,0,0,51
1126923,40,0,0,3,0,0,0,43
1126924,18,0,5,0,0,0,0,23
1126925,20,3,0,0,3,0,0,26
1126926,26,0,0,0,0,0,3,29
1126927,24,9,3,0,0,0,0,36
1126928,28,4,4,3,0,0,0,39
1126929,26,3,3,0,0,0,0,32
1126930,32,3,0,0,0,0,0,35
1126931,26,0,3,0,0,0,3,32
1126932,50,7,0,0,0,0,0,57
1126933,23,0,4,0,0,0,0,27
1126934,43,11,0,3,0,0,3,60
1126935,65,7,5,0,0,0,0,77
1126936,10,3,3,0,0,0,3,19
1126937,16,0,0,0,0,0,0,16
1126938,25,5,6,0,0,0,0,36
1126939,22,0,0,0,0,0,0,22
1126940,29,3,0,0,0,0,0,32
1126941,34,5,3,0,0,0,0,42
1126942,35,3,0,0,0,0,0,38
1126943,20,0,3,0,0,0,0,23
1126944,64,5,0,0,0,0,0,69
1126945,48,3,4,0,0,0,0,55
1126946,38,0,0,0,0,0,0,38
1126947,39,0,4,0,0,0,0,43
1126948,50,3,0,0,0,0,0,53
1126949,26,0,3,0,0,0,0,29
1127001,35,3,3,3,0,0,3,47
1127002,11,3,3,0,0,0,0,17
1127003,31,0,0,5,0,0,0,36
1127004,9,0,5,0,0,0,0,14
1127005,21,7,3,0,0,0,0,31
1127006,15,0,0,5,0,0,0,20
1127007,21,4,6,0,0,0,0,31
1127008,21,0,0,0,0,0,0,21
1127009,16,0,0,0,0,0,0,16
1127010,46,3,3,0,0,0,0,52
1127011,19,0,0,0,0,0,0,19
1127012,40,0,0,0,0,0,0,40
1127013,34,3,0,0,0,0,0,37
1127014,37,3,0,0,0,0,0,40
1127015,20,3,0,0,0,0,0,23
1127016,36,3,3,0,0,0,0,42
1127017,26,0,0,0,0,0,0,26
1127018,25,4,0,0,0,0,0,29
1127019,35,3,0,0,0,0,0,38
1127020,25,0,4,0,0,0,0,29
1127021,61,7,5,0,0,0,0,73
1127022,45,4,0,0,0,0,0,49
1127023,27,4,0,0,0,0,0,31
1127024,20,4,0,0,0,0,0,24
1127025,13,0,3,0,0,0,0,16
1127026,23,0,0,0,0,0,0,23
1127027,20,3,0,0,0,0,0,23
1127028,14,3,0,0,0,0,0,17
1127029,23,0,0,0,0,0,0,23
1127030,0,0,0,0,0,0,0,0
1127031,19,0,0,0,0,0,0,19
1127032,15,0,0,0,0,0,0,15
1127101,22,3,0,0,0,0,0,25
1127102,0,0,0,0,0,0,0,0
1127103,25,3,0,0,0,0,0,28
1127104,47,3,5,3,0,0,0,58
1127105,13,0,3,0,0,0,0,16
1127106,32,3,0,0,0,0,3,38
1127107,21,0,3,0,0,0,3,27
1127108,40,3,3,0,0,0,0,46
1127109,36,3,0,0,0,0,0,39
1127110,30,3,5,0,0,0,0,38
1127111,36,5,0,0,0,0,0,41
1127112,42,3,4,0,0,0,3,52
1127113,25,0,4,0,0,0,0,29
1127114,23,4,3,0,0,0,0,30
1127115,58,10,7,0,0,0,0,75
1127116,66,0,0,0,0,0,0,66
1127117,32,3,0,0,0,0,0,35
1127118,26,5,3,0,0,0,0,34
1127119,33,3,0,0,0,0,0,36
1127120,28,0,0,0,0,0,0,28
1127121,24,5,0,0,0,0,0,29
1127122,67,3,3,0,0,0,0,73
1127123,55,0,6,0,0,0,0,61
1127124,37,3,4,0,0,0,0,44
1127125,24,6,0,0,0,0,0,30
1127126,29,3,3,0,0,0,0,35
1127127,44,9,0,0,0,0,3,56
1127128,38,5,0,0,0,0,0,43
1127129,78,0,3,0,0,0,0,81
1127130,42,0,3,0,0,0,0,45
1127131,17,0,5,0,0,0,0,22
1127132,32,6,4,0,0,0,0,42
1127133,7,0,0,0,0,0,0,7
1127134,0,0,0,0,0,0,0,0
1127135,33,0,4,0,0,0,0,37
1127136,77,3,3,3,0,0,3,89
1127137,68,3,3,0,0,0,0,74
1127138,50,4,8,0,0,0,0,62
1127139,29,3,4,0,0,0,4,40
1127140,17,0,3,0,0,0,0,20
1127141,32,0,3,0,0,0,0,35
1127142,19,0,0,0,0,0,0,19
1127201,36,6,0,0,0,0,0,42
1127202,63,7,0,0,0,0,0,70
1127203,32,0,0,0,0,0,0,32
1127204,32,4,0,0,0,0,0,36
1127205,26,0,0,0,0,0,0,26
1127206,27,3,0,0,0,0,0,30
1127207,36,5,0,3,0,0,0,44
1127208,11,0,0,0,0,0,0,11
1127209,46,4,0,0,0,0,0,50
1127210,29,3,0,0,0,0,3,35
1127211,37,0,0,0,0,0,0,37
1127212,19,3,0,3,0,0,0,25
1127213,43,3,0,0,0,0,0,46
1127214,25,0,0,0,0,0,0,25
1127215,24,0,3,0,0,0,0,27
1127216,12,0,0,0,0,0,0,12
1127217,42,4,3,0,0,0,0,49
1127218,12,0,0,0,0,3,0,15
1127219,0,6,0,0,0,0,0,6
1127220,23,4,3,0,0,0,0,30
1127221,15,0,0,0,0,0,0,15
1127222,40,5,3,0,0,0,0,48
1127223,29,5,0,0,0,0,0,34
1127224,27,4,0,0,0,0,0,31
1127301,5,3,0,0,0,0,0,8
1127302,22,4,6,0,0,0,0,32
1127303,22,3,0,0,0,0,0,25
1127304,31,0,0,0,0,0,0,31
1127305,41,5,0,0,0,0,0,46
1127306,35,6,0,0,0,0,0,41
1127307,41,4,0,0,0,0,0,45
1127308,49,0,5,0,0,0,0,54
1127309,12,0,0,0,0,0,0,12
1127310,31,3,3,0,0,0,0,37
1127311,0,0,0,0,0,0,0,0
1127312,4,0,0,0,0,0,0,4
1127401,16,4,0,0,0,0,0,20
1127402,5,3,3,0,0,3,0,14
1127403,25,0,0,3,0,0,0,28
1127404,30,0,4,0,0,0,0,34
1127405,22,3,0,0,0,0,0,25
1127406,25,0,0,0,0,0,0,25
1127407,26,3,0,0,0,0,0,29
1127408,38,3,3,0,0,0,0,44
1127409,13,0,3,0,0,0,0,16
1127410,14,6,3,0,0,0,0,23
1127411,28,3,0,4,0,0,0,35
1127412,22,0,0,0,0,0,0,22
1127413,15,8,3,0,0,0,0,26
1127414,23,0,0,0,0,0,0,23
1127415,0,0,0,0,0,0,0,0
1127416,32,3,3,3,0,0,3,44
1127501,0,0,0,0,0,0,0,0
1127601,18,0,0,0,0,0,0,18
1127602,22,6,0,0,0,0,0,28
1127603,31,3,0,0,0,0,3,37
1127604,23,3,3,0,0,0,0,29
1127605,24,0,0,0,0,0,0,24
1127606,33,5,3,0,0,0,0,41
1127607,26,0,0,0,0,0,0,26
1127608,23,3,0,0,0,0,0,26
1127609,45,3,3,0,3,0,0,54
1127610,16,0,3,3,0,0,3,25
1127701,41,5,3,0,0,0,0,49
1127702,22,3,3,0,0,0,0,28
1127703,25,4,4,0,0,0,0,33
1127704,31,3,0,0,0,0,0,34
1127705,16,3,3,0,0,0,0,22
1127706,24,0,0,0,0,0,0,24
1127707,22,0,0,0,0,0,0,22
1127708,43,0,3,0,0,0,3,49
1127709,25,4,5,0,0,0,0,34
1127710,35,0,0,3,0,0,0,38
1127711,71,3,3,0,0,0,0,77
1127712,35,4,0,0,0,0,0,39
1127713,17,3,0,0,0,0,0,20
1127714,25,3,3,0,0,0,0,31
1127715,31,4,0,0,0,0,0,35
1127716,31,0,0,0,0,0,0,31
1127717,53,3,9,0,0,3,0,68
1127718,44,6,5,0,0,0,3,58
1127719,22,0,4,3,0,0,0,29
1127720,27,0,0,0,0,0,0,27
1127721,62,8,6,0,0,0,0,76
1127722,40,3,3,3,0,0,0,49
1127723,23,0,5,0,0,0,0,28
1127724,12,0,0,0,0,0,0,12
1127725,44,8,3,0,0,0,0,55
1127726,36,5,3,0,0,0,0,44
1127727,67,8,5,0,0,0,3,83
1127728,39,4,4,0,0,0,0,47
1127729,29,6,3,0,0,0,0,38
1127730,69,5,6,0,0,0,0,80
1127731,44,5,0,0,0,0,0,49
1127732,60,7,0,3,0,0,0,70
1127733,41,9,3,0,0,0,0,53
1127734,31,3,3,0,0,0,0,37
1127735,34,4,3,0,0,0,3,44
1127736,15,6,0,0,0,0,0,21
1127737,44,0,5,3,0,0,0,52
1127738,29,3,0,3,0,0,0,35
1127739,34,3,3,0,0,3,3,46
1127740,0,0,0,0,0,0,0,0
1127741,27,3,0,3,0,0,0,33
1127801,54,3,8,0,0,0,0,65
1127802,40,3,3,0,0,0,0,46
1127803,50,6,8,0,0,0,0,64
1127804,19,0,4,0,0,0,0,23
1127805,0,0,0,0,0,0,0,0
1127806,7,0,0,0,0,0,0,7
1127807,32,0,0,0,0,0,3,35
1127808,7,0,0,0,0,0,0,7
1127809,16,3,0,0,0,0,0,19
1127810,13,0,6,0,0,0,0,19
1127811,23,0,0,0,0,0,0,23
1127812,23,4,9,0,0,0,5,41
1127813,42,3,0,4,0,0,0,49
1127814,85,6,6,0,0,0,0,97
1127815,35,3,3,3,0,0,0,44
1127816,22,0,0,0,0,5,0,27
1127817,22,3,0,0,0,0,0,25
1127818,24,3,0,0,0,0,0,27
1127819,19,0,0,0,0,0,0,19
1127820,37,3,3,0,0,0,0,43
1127821,23,0,3,0,0,0,0,26
1127822,55,5,3,0,3,0,0,66
1127823,23,0,3,0,0,0,0,26
1127824,3,0,3,0,0,0,0,6
1127825,47,5,4,0,0,0,0,56
1127826,81,3,8,0,0,0,0,92
1127827,41,0,0,0,0,0,0,41
1127828,53,3,3,0,0,0,0,59
1127829,44,3,5,0,0,0,0,52
1127830,19,3,3,0,0,0,0,25
1127831,13,3,3,0,0,0,0,19
1127832,56,3,0,0,0,0,0,59
1127833,21,3,0,0,0,0,0,24
1127834,21,3,0,0,0,0,0,24
1127835,23,0,3,0,0,0,0,26
1127836,22,0,3,0,0,0,0,25
1127837,21,3,3,0,0,0,0,27
1127838,21,4,0,0,0,0,0,25
1127839,50,12,3,0,0,0,4,69
1127840,29,3,0,0,0,0,0,32
1127841,29,0,3,0,0,0,0,32
1127842,10,3,4,0,0,0,0,17
1127843,41,0,0,0,0,0,4,45
1127844,26,5,3,0,0,0,0,34
1127845,37,3,0,0,0,0,0,40
1127846,49,10,0,0,0,0,0,59
1127901,0,0,0,0,0,0,0,0
1127902,0,0,0,0,0,0,0,0
1127903,0,0,0,0,0,0,0,0
1127904,44,3,3,0,0,0,0,50
1127905,38,3,5,0,0,0,3,49
1127906,29,3,0,0,0,0,3,35
1127907,33,0,0,0,0,0,0,33
1127908,37,0,4,0,0,0,0,41
1127909,19,3,0,0,0,0,0,22
1127910,27,6,3,0,0,0,3,39
1127911,73,7,0,0,0,0,3,83
1127912,19,4,0,0,0,0,0,23
1127913,39,0,3,0,0,0,3,45
1127914,11,3,3,0,0,0,0,17
1127915,31,4,3,0,0,0,0,38
1127916,37,9,3,0,0,0,3,52
1127917,31,0,4,0,0,0,0,35
1127918,22,4,0,0,0,0,0,26
1127919,14,3,3,0,0,3,0,23
1127920,5,3,0,0,0,0,0,8
1127921,28,0,3,0,3,0,3,37
1127922,26,5,5,0,0,0,0,36
1127923,53,3,0,0,0,0,3,59
1127924,10,3,0,0,0,0,0,13
1127925,17,3,0,0,0,0,0,20
1127926,8,3,3,3,0,0,0,17
1127927,33,6,0,0,0,0,0,39
1127928,20,3,3,0,0,0,0,26
1127929,22,3,0,3,0,0,0,28
1127930,15,3,0,0,0,0,0,18
1127931,25,10,0,0,0,0,0,35
1127932,16,0,0,0,0,0,3,19
1127933,15,3,4,0,0,0,3,25
1127934,36,3,3,0,0,0,0,42
1127935,22,0,3,0,0,0,0,25
1127936,45,6,0,6,0,0,0,57
1127937,33,6,5,0,0,0,0,44
1127938,0,0,0,0,0,0,0,0
1128001,11,0,0,0,0,0,0,11
1128002,10,3,3,0,0,0,0,16
1128003,23,0,4,0,0,0,0,27
1128004,19,0,3,0,0,0,0,22
1128005,32,4,0,0,0,0,0,36
1128006,24,0,4,0,0,0,0,28
1128007,0,0,0,0,0,0,0,0
1128008,19,5,0,0,0,0,0,24
1128009,13,4,3,0,0,0,0,20
1128010,9,0,0,0,0,0,0,9
1128011,12,3,0,0,0,0,0,15
1128012,12,0,0,0,0,0,0,12
1128013,24,0,0,0,0,0,0,24
1128014,20,3,0,0,0,0,0,23
1128101,33,4,0,3,0,0,3,43
1128102,38,0,0,0,0,0,0,38
1128103,45,3,8,0,0,0,0,56
1128104,36,3,3,0,0,0,3,45
1128105,36,0,0,3,0,3,0,42
1128106,25,0,0,0,0,0,0,25
1128107,29,4,0,0,0,0,0,33
1128108,38,0,3,3,0,0,0,44
1128109,33,5,0,0,0,0,0,38
1128110,46,0,4,0,0,0,0,50
1128201,0,0,0,0,0,0,0,0
1128202,22,8,0,0,0,0,0,30
1128203,60,5,7,6,0,0,0,78
1128204,55,0,3,3,0,0,0,61
1128205,24,3,3,0,0,0,3,33
1128206,32,3,3,0,3,0,0,41
1128207,10,0,3,0,0,0,0,13
1128208,25,3,0,0,0,0,0,28
1128209,22,0,0,0,0,0,4,26
1128210,26,3,3,0,0,0,0,32
1128211,23,0,3,0,0,0,0,26
1128212,41,4,3,0,0,0,3,51
1128213,13,0,0,0,0,0,0,13
1128214,31,3,0,0,0,0,0,34
1128215,44,3,3,0,0,0,0,50
1128216,20,0,0,0,0,0,0,20
1128217,30,3,11,0,0,0,0,44
1128218,30,0,0,0,0,0,0,30
1128219,24,0,3,0,0,0,0,27
1128220,18,0,0,0,0,0,0,18
1128221,29,5,0,0,0,0,0,34
1128222,21,5,6,0,0,0,0,32
1128223,26,3,6,0,0,0,0,35
1128224,33,0,0,0,0,0,0,33
1128225,13,3,3,0,0,0,0,19
1128226,38,7,3,0,0,0,0,48
1128227,30,0,0,0,0,0,0,30
1128228,25,3,3,0,0,0,3,34
1128229,37,3,3,0,0,0,0,43
1128230,26,3,3,0,0,0,0,32
1128231,33,4,4,0,0,0,0,41
1128232,21,3,0,0,0,0,0,24
1128233,29,3,3,0,0,0,0,35
1128234,17,4,0,0,0,0,0,21
1128235,30,3,3,0,0,0,3,39
1128236,13,3,0,0,0,0,0,16
1128237,43,3,4,0,0,0,0,50
1128238,12,0,0,0,0,0,0,12
1128239,15,3,4,0,0,0,0,22
1128301,11,3,0,0,0,0,0,14
1128302,32,0,0,0,0,0,0,32
1128303,20,0,0,0,0,0,0,20
1128304,26,3,3,0,0,0,0,32
1128305,48,9,0,0,0,0,0,57
1128306,29,0,0,0,0,0,4,33
1128307,30,0,3,3,0,0,0,36
1128308,28,0,0,3,0,0,0,31
1128309,39,0,0,0,0,0,0,39
1128310,22,0,0,0,0,0,0,22
1128311,0,0,0,0,0,0,0,0
1128312,4,0,0,0,0,0,0,4
1128313,35,0,3,0,0,0,0,38
1128314,31,3,0,0,0,0,0,34
1128315,18,0,0,3,0,0,0,21
1128316,5,0,3,0,0,0,0,8
1128317,25,3,0,0,0,0,0,28
1128401,24,3,0,0,0,0,0,27
1128402,27,0,0,0,0,0,0,27
1128403,31,3,3,0,0,0,0,37
1128404,51,4,0,0,0,0,0,55
1128405,38,7,0,0,0,3,0,48
1128406,47,0,6,0,0,0,0,53
1128407,53,4,3,0,0,0,3,63
1128408,36,4,0,0,0,0,0,40
1128409,75,4,11,0,0,0,0,90
1128410,16,3,0,0,0,0,0,19
1128411,58,6,6,0,0,0,0,70
1128412,46,0,0,0,0,0,0,46
1128413,25,3,0,0,0,0,0,28
1128414,20,0,0,0,0,0,0,20
1128415,32,0,0,0,0,0,0,32
1128416,33,3,3,0,0,0,0,39
1128417,16,0,5,0,0,0,0,21
1128418,31,3,0,0,0,0,0,34
1128419,23,0,0,0,0,0,0,23
1128420,31,3,3,0,0,0,0,37
1128421,37,0,0,0,0,0,0,37
1128422,51,0,4,0,0,0,0,55
1128423,29,0,0,0,0,0,0,29
1128424,27,0,0,0,0,0,0,27
1128425,34,3,0,0,0,0,0,37
1128426,60,7,4,0,0,0,0,71
1128427,20,3,0,0,0,0,0,23
1128428,33,3,0,0,0,0,0,36
1128429,11,0,0,0,0,0,0,11
1128430,58,3,0,3,0,0,0,64
1128431,12,0,0,0,0,0,0,12
1128501,41,3,3,0,0,0,0,47
1128502,46,0,4,0,0,0,0,50
1128503,25,3,0,0,0,0,0,28
1128504,31,6,3,0,0,0,0,40
1128505,51,3,3,0,0,0,3,60
1128506,65,12,0,0,0,0,0,77
1128507,55,3,3,0,0,0,3,64
1128508,42,0,3,0,0,3,0,48
1128509,51,0,3,0,0,0,0,54
1128510,52,3,0,0,0,0,0,55
1128511,39,0,3,0,0,0,0,42
1128512,24,8,0,0,0,0,0,32
1128513,60,10,9,0,0,0,0,79
1128514,27,6,0,0,0,0,0,33
1128515,38,6,0,0,0,0,0,44
1128516,3,0,0,0,0,0,0,3
1128601,34,0,0,0,0,0,0,34
1128602,0,0,0,0,0,0,0,0
1128603,39,0,0,0,0,0,0,39
1128604,50,3,0,0,0,0,0,53
1128605,35,3,3,0,0,0,0,41
1128606,43,3,0,3,0,0,0,49
1128607,28,3,3,0,0,0,0,34
1128608,11,0,4,0,0,0,0,15
1128609,18,3,4,0,0,0,0,25
1128610,31,3,3,0,0,0,0,37
1128611,37,5,0,0,0,0,0,42
1128612,0,0,0,0,0,0,0,0
1128613,44,3,3,0,0,0,0,50
1128614,35,3,3,0,0,0,0,41
1128615,59,7,0,0,0,0,0,66
1128616,20,3,0,0,0,0,0,23
1128617,34,3,3,0,0,0,0,40
1128618,22,0,3,0,0,0,0,25
1128619,37,0,3,0,0,0,0,40
1128620,59,4,0,0,0,3,0,66
1128621,20,4,4,0,0,0,0,28
1128622,34,4,3,0,0,0,0,41
1128623,30,3,0,0,0,0,0,33
1128701,42,0,0,0,0,0,0,42
1128702,48,0,6,0,0,0,0,54
1128703,39,3,9,0,0,0,0,51
1128704,51,8,4,0,0,0,0,63
1128705,37,7,4,0,0,0,0,48
1128706,20,3,3,0,0,0,0,26
1128707,32,3,5,0,0,3,0,43
1128708,41,4,0,0,0,0,0,45
1128709,42,3,0,0,0,0,0,45
1128710,40,0,5,0,0,0,0,45
1128711,21,3,0,0,0,0,0,24
1128712,11,0,3,0,0,0,0,14
1128713,11,0,4,4,0,0,0,19
1128714,85,9,6,0,0,0,0,100
1128715,5,0,3,0,0,0,0,8
1128716,45,0,3,0,0,0,0,48
1128717,13,0,3,0,0,0,0,16
1128718,30,6,0,0,0,0,0,36
1128719,32,3,5,0,0,0,0,40
1128720,15,0,0,0,0,0,0,15
1128721,60,5,4,0,0,0,0,69
1128722,0,0,0,0,0,0,0,0
1128723,44,0,5,0,0,0,0,49
1128724,26,3,0,0,0,0,0,29
1128725,11,3,3,0,0,0,0,17
1128726,0,0,0,0,0,0,0,0
1128801,11,0,3,0,0,0,0,14
1128802,28,0,0,0,0,0,0,28
1128803,26,4,0,0,0,0,0,30
1128804,26,3,0,0,0,0,3,32
1128805,28,0,0,0,0,0,0,28
1128806,35,0,0,0,0,0,0,35
1128807,44,3,0,3,0,0,0,50
1128808,13,0,0,0,0,0,0,13
1128809,22,3,0,0,0,0,0,25
1128810,0,0,0,0,0,0,0,0
1128811,19,0,0,0,0,0,0,19
1128812,88,10,6,0,0,0,0,104
1128901,49,4,3,0,0,0,0,56
1128902,29,0,3,0,0,3,0,35
1128903,51,10,3,0,0,0,0,64
1128904,65,3,3,0,0,0,0,71
1128905,20,0,0,0,0,0,0,20
1128906,49,3,0,0,0,0,0,52
1128907,26,8,0,0,0,0,0,34
1128908,22,0,3,0,0,0,0,25
1128909,33,0,0,0,0,0,0,33
1128910,21,0,5,0,0,0,0,26
1128911,14,4,0,0,0,0,0,18
1128912,14,0,0,0,0,0,0,14
1128913,22,0,0,0,0,0,0,22
1128914,29,5,3,0,0,0,0,37
1128915,22,5,0,0,0,0,0,27
1128916,23,3,0,0,0,0,0,26
1128917,26,0,4,0,0,0,0,30
1128918,27,3,0,0,0,0,0,30
1128919,17,3,0,0,0,0,0,20
1129001,65,3,0,0,0,0,0,68
1129002,77,5,0,0,0,3,0,85
1129003,48,8,3,3,0,0,0,62
1129004,53,0,0,0,0,0,0,53
1129005,84,3,0,0,0,0,0,87
1129006,63,3,0,0,0,0,0,66
1129007,53,3,0,0,0,0,0,56
1129008,93,6,0,0,0,0,0,99
1129009,72,3,3,0,0,0,0,78
1129010,74,3,3,0,0,0,0,80
1129011,59,0,0,0,0,0,0,59
1129012,79,3,0,0,0,0,0,82
1129013,79,8,3,0,0,0,0,90
1129014,75,3,0,0,0,0,0,78
1129015,64,6,3,3,0,0,0,76
1129016,94,3,3,0,0,0,0,100
1129017,39,0,0,4,0,0,0,43
1129018,90,4,0,3,0,0,0,97
1129019,48,7,0,0,0,0,0,55
1129020,57,6,0,0,0,0,0,63
1129021,82,3,3,3,0,0,0,91
1129022,61,3,0,0,0,0,0,64
1129023,53,5,0,0,0,0,0,58
1129024,82,4,3,0,0,0,0,89
1129025,47,0,0,3,0,0,0,50
1129026,89,7,3,0,0,0,0,99
1129027,54,0,0,0,0,0,0,54
1129028,71,0,3,0,0,0,0,74
1129029,77,3,0,3,0,0,0,83
1129030,51,3,0,3,0,0,0,57
1129031,80,3,3,3,0,0,0,89
1129032,71,3,3,0,0,0,0,77
1129033,91,8,3,0,0,0,0,102
1129034,28,3,0,0,0,0,0,31
1129035,81,0,0,0,0,0,0,81
1129036,49,5,0,0,0,0,0,54
1129037,88,7,0,0,0,0,0,95
1129038,35,4,0,0,0,0,0,39
1129039,35,3,0,0,0,0,0,38
1129040,63,9,4,0,0,0,0,76
1129041,32,7,0,0,0,0,0,39
1129042,68,6,0,0,0,0,0,74
1129043,87,3,3,0,0,0,0,93
1129044,52,0,0,0,0,0,0,52
1129045,86,0,4,0,0,0,0,90
1129046,24,0,4,0,0,0,0,28
1129047,45,4,0,4,0,0,0,53
1129101,48,4,0,0,0,0,0,52
1129102,69,3,3,4,0,0,0,79
1129103,87,0,3,0,0,0,0,90
1129104,68,3,0,0,0,0,0,71
1129105,83,0,0,0,0,0,0,83
1129106,59,7,3,0,0,0,0,69
1129107,44,0,0,0,0,0,0,44
1129108,89,0,3,0,0,0,0,92
1129109,86,3,0,0,0,0,0,89
1129110,86,3,3,0,0,0,0,92
1129111,102,3,3,3,0,0,0,111
1129112,72,4,0,0,0,0,0,76
1129113,29,3,0,3,0,0,0,35
1129114,63,5,0,0,0,0,0,68
1129115,79,3,0,0,0,0,0,82
1129116,83,5,3,3,0,0,0,94
1129117,57,4,3,0,0,0,0,64
1129118,58,5,3,0,0,0,0,66
1129119,71,0,3,0,0,0,0,74
1129120,58,3,4,3,0,0,0,68
1129121,72,4,3,0,0,0,0,79
1129122,44,5,0,0,0,0,0,49
1129123,58,3,0,0,0,0,0,61
1129124,52,0,3,0,0,0,0,55
1129125,14,4,0,0,0,0,0,18
1129126,188,12,3,3,0,0,0,206
1129127,0,0,0,0,0,0,0,0
1129128,78,4,0,0,0,0,0,82
1129129,97,5,4,0,0,0,0,106
1129130,31,3,0,0,0,0,0,34
1129131,62,3,3,0,0,0,0,68
1129132,33,0,0,0,0,0,0,33
1129133,69,4,3,0,0,0,0,76
1129134,49,0,0,0,0,0,0,49
1129135,34,0,0,0,0,0,0,34
1129136,38,0,0,4,0,0,0,42
1129137,78,0,5,0,0,0,0,83
1129138,0,0,0,0,0,0,0,0
1129139,57,3,0,0,0,0,0,60
1129140,71,5,0,0,0,0,0,76
1129141,55,4,3,4,0,0,0,66
1129142,76,3,0,0,0,0,0,79
1129143,121,3,3,3,0,0,0,130
1129144,75,4,0,0,0,0,0,79
1129145,80,0,3,0,0,0,0,83
1129146,61,3,3,0,0,0,0,67
1129147,0,0,0,0,0,0,0,0
1129201,39,3,0,0,0,0,0,42
1129202,91,6,3,0,0,0,0,100
1129203,64,4,4,0,0,0,0,72
1129204,74,6,3,0,0,0,0,83
1129205,60,0,0,0,0,0,0,60
1129206,68,3,3,3,0,0,0,77
1129207,48,3,0,0,0,0,0,51
1129208,40,4,0,0,0,0,0,44
1129209,58,3,0,0,0,0,0,61
1129210,82,3,4,0,0,0,0,89
1129211,37,0,0,0,0,0,0,37
1129212,65,3,3,0,0,0,0,71
1129213,86,6,0,0,0,0,0,92
1129214,0,0,0,0,0,0,0,0
1129215,39,0,5,0,0,0,0,44
1129216,40,0,0,0,0,0,0,40
1129217,84,10,3,0,0,0,0,97
1129218,85,6,5,0,0,0,0,96
1129219,84,6,0,0,0,0,0,90
1129220,48,3,3,0,0,0,0,54
1129221,62,5,0,0,0,0,0,67
1129222,58,3,0,0,0,0,0,61
1129223,47,3,3,0,0,0,0,53
1129224,65,0,0,0,0,0,0,65
1129225,103,3,9,0,0,0,0,115
1129226,32,0,0,0,0,0,0,32
1129227,107,4,0,0,0,0,0,111
1129228,96,4,0,0,0,0,0,100
1129229,48,0,0,0,0,0,0,48
1129230,105,3,0,3,0,0,0,111
1129231,74,6,0,0,0,0,0,80
1129232,35,0,0,4,0,0,0,39
1129233,65,4,0,0,0,0,0,69
1129234,59,3,3,0,0,0,0,65
1129235,55,3,0,0,0,0,0,58
1129236,53,3,0,3,0,0,0,59
1129237,58,4,3,0,0,0,0,65
1129238,82,6,0,0,0,0,0,88
1129239,66,3,3,3,0,0,0,75
1129240,65,4,3,3,0,0,0,75
1129241,89,3,3,0,0,0,0,95
1129242,82,4,3,0,0,0,0,89
1129243,0,0,0,0,0,0,0,0
1129244,40,4,0,0,0,0,0,44
1129245,67,3,0,0,0,0,3,73
1129246,84,0,0,0,0,0,0,84
1129247,37,4,3,0,0,0,0,44
1129248,59,6,0,0,0,0,0,65
1129249,46,0,0,3,0,0,0,49
1129250,68,3,0,0,0,0,0,71
1129251,91,3,0,0,0,0,0,94
1129252,0,0,0,0,0,0,0,0
1129253,50,0,0,0,0,0,0,50
1129254,56,3,3,3,0,0,0,65
1129255,44,0,0,0,0,0,0,44
1129256,57,0,0,0,0,0,0,57
1129257,78,8,3,0,0,0,0,89
1129258,73,4,0,0,0,0,0,77
1129259,85,0,3,0,0,0,0,88
1129260,56,9,3,0,0,0,0,68
1129261,108,5,0,0,0,0,0,113
1129262,87,0,4,0,0,0,0,91
1129263,30,6,0,0,0,0,0,36
1129264,48,0,4,0,0,0,0,52
1129301,65,4,0,0,0,0,0,69
1129302,69,7,0,0,0,0,0,76
1129303,103,8,3,0,0,0,0,114
1129304,56,3,0,0,0,0,0,59
1129305,91,0,3,0,0,0,0,94
1129306,53,4,0,0,0,0,0,57
1129307,53,0,0,0,0,0,0,53
1129308,64,3,0,4,0,0,0,71
1129309,41,0,0,0,0,0,0,41
1129310,60,13,0,0,0,0,0,73
1129311,48,3,3,0,0,0,0,54
1129312,32,3,0,0,0,0,0,35
1129313,40,4,0,0,0,0,0,44
1129314,48,0,0,5,0,0,0,53
1129315,88,0,0,4,0,0,0,92
1129316,58,0,0,5,0,0,0,63
1129317,84,3,3,3,0,0,0,93
1129318,43,3,3,0,0,0,0,49
1129319,70,5,0,0,0,0,0,75
1129320,55,3,3,0,0,0,0,61
1129321,56,3,0,0,0,0,0,59
1129322,40,0,0,0,0,0,0,40
1129323,30,0,0,0,0,0,0,30
1129324,43,0,0,0,0,0,0,43
1129325,69,3,0,3,0,0,0,75
1129326,36,0,0,0,0,0,0,36
1129327,67,3,3,0,0,0,3,76
1129328,59,0,0,0,0,0,0,59
1129329,59,0,5,0,0,0,0,64
1129330,58,0,0,0,0,0,0,58
1129331,76,3,7,0,0,0,0,86
1129332,60,4,0,0,0,0,0,64
1129333,81,4,0,3,0,0,4,92
1129334,71,3,0,0,0,0,3,77
1129335,54,6,4,0,0,0,0,64
1129336,99,0,0,4,0,0,0,103
1129337,117,3,3,0,0,0,0,123
1129338,62,4,4,0,0,0,0,70
1129339,72,3,0,0,0,0,0,75
1129340,56,3,0,3,0,0,0,62
1129341,44,3,0,0,0,0,0,47
1129342,14,0,0,0,0,0,0,14
1129343,0,0,0,0,0,0,0,0
1129344,37,0,0,0,0,0,0,37
1129345,0,0,0,0,0,0,0,0
1129346,0,0,0,0,0,0,0,0
1129347,73,0,0,0,0,0,0,73
1129348,65,3,3,0,0,0,0,71
1129349,40,4,0,0,0,0,0,44
1129350,26,3,0,0,0,0,0,29
1129351,93,3,5,0,0,0,0,101
1129352,71,3,3,0,0,0,0,77
1129353,65,0,0,0,0,0,0,65
1129354,55,3,3,0,0,0,0,61
1129355,62,0,0,3,0,0,0,65
1129356,81,3,3,3,0,0,0,90
1129357,76,3,3,0,0,0,0,82
1129358,77,6,3,0,0,0,0,86
1129359,67,3,3,0,0,0,0,73
1129360,69,0,0,0,0,0,0,69
1129361,45,4,0,0,0,0,0,49
1129362,78,3,3,0,0,0,0,84
1129363,96,3,3,3,0,0,0,105
1129364,71,0,0,0,0,0,0,71
1129401,98,4,4,0,0,0,0,106
1129402,46,10,4,0,0,0,0,60
1129403,10,0,0,0,0,0,0,10
1129404,13,0,0,0,0,0,0,13
1129405,37,0,0,0,0,0,0,37
1129406,59,5,0,0,0,0,0,64
1129407,50,3,0,0,0,0,0,53
1129408,72,5,3,0,0,0,0,80
1129409,48,5,0,0,0,0,0,53
1129410,39,6,0,0,0,0,0,45
1129411,36,4,3,0,0,0,0,43
1129412,68,3,6,3,0,0,0,80
1129413,92,7,0,0,0,0,0,99
1129414,55,4,5,0,0,0,0,64
1129415,41,0,0,4,0,0,0,45
1129416,71,5,0,0,0,0,0,76
1129501,35,4,0,0,0,0,0,39
1129502,90,3,3,0,0,0,0,96
1129503,67,3,0,0,0,3,0,73
1129504,108,14,0,0,0,0,0,122
1129505,119,3,9,3,0,0,0,134
1129506,86,7,3,3,0,0,0,99
1129507,59,3,3,0,0,0,0,65
1129508,76,3,3,0,0,0,0,82
1129509,132,5,3,0,0,0,0,140
1129510,86,6,3,0,0,0,0,95
1129511,69,3,3,3,0,0,0,78
1129512,105,0,6,0,0,0,0,111
1129513,72,3,3,3,0,0,0,81
1129514,98,5,0,0,0,0,3,106
1129515,95,5,0,5,0,0,0,105
1129516,118,9,3,3,0,0,0,133
1129517,52,0,0,0,0,0,0,52
1129518,64,3,5,0,0,0,0,72
1129519,79,4,0,0,0,0,0,83
1129520,79,3,3,0,0,0,0,85
1129521,44,5,0,0,0,0,0,49
1129522,105,5,9,3,0,0,0,122
1129523,94,0,3,0,0,0,0,97
1129524,100,8,4,0,0,0,0,112
1129525,97,0,3,0,0,0,0,100
1129526,75,3,0,0,0,0,0,78
1129527,92,9,0,0,0,0,0,101
1129528,62,3,3,0,0,0,0,68
1129529,83,4,0,0,0,0,0,87
1129530,77,7,3,0,0,0,0,87
1129531,34,3,3,0,0,0,0,40
1129532,60,5,3,4,0,0,0,72
1129533,73,0,0,0,0,0,0,73
1129534,76,3,0,0,0,0,0,79
1129535,166,4,3,0,0,0,0,173
1129536,76,3,3,0,0,0,0,82
1129537,96,4,0,4,0,0,0,104
1129538,98,4,7,0,0,0,0,109
1129539,56,6,3,0,0,0,0,65
1129540,45,0,5,0,0,0,0,50
1129541,54,0,0,0,0,0,0,54
1129542,80,5,0,0,0,0,0,85
1129543,67,3,3,0,0,0,0,73
1129544,91,3,3,0,0,0,0,97
1129545,99,6,4,3,0,0,0,112
1129546,116,7,3,0,0,0,0,126
1129547,72,3,0,3,0,0,0,78
1129548,93,3,3,0,0,0,3,102
1129601,63,3,0,0,0,0,0,66
1129602,52,0,3,0,0,0,0,55
1129603,50,0,0,0,0,0,0,50
1129604,40,3,3,0,3,0,0,49
1129605,65,0,0,0,0,0,0,65
1129606,81,3,0,0,0,0,0,84
1129607,43,0,3,0,0,0,0,46
1129608,44,5,0,0,0,0,0,49
1129609,62,3,0,0,0,0,0,65
1129610,94,3,3,3,0,0,0,103
1129611,72,6,4,0,0,0,0,82
1129612,62,0,0,0,0,0,0,62
1129613,60,3,3,3,0,0,0,69
1129614,117,0,0,5,0,0,0,122
1129615,75,0,0,3,0,0,0,78
1129616,71,4,3,0,0,0,0,78
1129617,63,4,4,0,0,0,0,71
1129618,21,3,0,0,0,0,0,24
1129619,66,0,3,5,0,0,0,74
1129620,81,5,3,0,0,0,0,89
1129621,70,0,3,0,0,0,0,73
1129622,101,0,0,0,0,0,0,101
1129623,54,0,3,0,0,0,0,57
1129624,38,3,0,0,0,0,0,41
1129625,83,0,0,0,0,0,3,86
1129626,43,3,0,0,0,0,0,46
1129627,66,3,3,0,0,0,0,72
1129628,89,7,0,0,0,0,0,96
1129629,77,3,7,0,0,0,0,87
1129630,46,3,3,0,0,0,0,52
1129631,67,3,3,0,0,0,0,73
1129632,84,4,0,5,0,0,0,93
1129701,65,3,0,0,0,0,0,68
1129702,50,3,3,0,0,3,0,59
1129703,59,0,3,0,0,0,0,62
1129704,39,6,0,0,0,0,0,45
1129705,34,0,4,0,0,0,0,38
1129706,31,0,0,0,0,0,0,31
1129707,25,3,3,0,0,0,3,34
1129708,37,0,0,0,0,0,0,37
1129709,65,3,3,0,0,0,0,71
1129710,51,5,0,0,0,0,0,56
1129711,40,0,0,0,0,0,0,40
1129712,50,0,0,0,0,0,0,50
1129713,32,4,0,0,0,0,0,36
1129714,68,5,0,0,0,0,0,73
1129715,43,6,4,0,0,0,0,53
1129716,34,5,0,0,0,0,0,39
1129717,40,0,0,0,0,0,0,40
1129718,50,5,0,0,0,0,0,55
1129719,49,9,0,0,0,0,0,58
1129720,39,7,4,0,0,0,0,50
1129721,31,5,3,0,0,0,0,39
1129722,66,9,0,0,0,0,0,75
1129723,23,3,3,3,0,0,0,32
1129724,37,0,4,0,0,0,0,41
1129725,39,4,0,0,0,0,0,43
1129726,28,3,3,0,0,0,0,34
1129727,8,3,0,0,0,0,0,11
1129728,41,7,0,3,0,0,0,51
1129729,37,3,0,4,0,0,0,44
1129730,29,4,0,0,0,0,0,33
1129731,45,3,0,0,0,0,0,48
1129732,61,3,5,0,0,0,0,69
1129733,52,3,3,3,0,0,0,61
1129734,64,6,4,4,0,0,0,78
1129735,33,4,0,0,0,0,0,37
1129736,68,4,3,3,0,0,0,78
1129737,74,6,4,0,0,0,0,84
1129738,43,3,0,3,0,0,0,49
1129739,56,5,0,0,0,0,0,61
1129740,34,0,0,0,0,0,0,34
1129741,38,3,3,0,0,0,0,44
1129742,44,0,3,0,0,0,0,47
1129743,67,0,0,0,0,0,0,67
1129744,67,6,4,0,0,0,0,77
1129745,50,3,0,0,0,0,0,53
1129746,59,0,3,0,0,0,0,62
1129747,71,4,0,0,0,0,0,75
1129748,57,5,3,0,0,0,0,65
1129749,46,3,3,0,0,0,0,52
1129750,52,4,0,0,0,0,0,56
1129751,59,4,4,0,0,0,0,67
1129752,70,3,4,0,0,0,0,77
1129753,68,3,3,0,0,0,0,74
1129754,57,0,4,0,0,0,0,61
1129755,62,5,0,0,0,0,0,67
1129756,67,4,3,0,0,0,0,74
1129757,34,6,0,0,0,0,0,40
1129758,38,3,0,0,0,0,0,41
1129801,42,3,3,0,0,0,0,48
1129802,40,3,0,3,0,0,0,46
1129803,53,3,3,0,0,0,0,59
1129804,39,4,4,0,0,0,0,47
1129805,27,3,0,0,0,0,0,30
1129806,43,3,0,0,0,0,0,46
1129807,63,0,4,0,0,0,0,67
1129808,44,3,3,0,0,0,0,50
1129809,46,0,0,0,0,0,0,46
1129810,27,0,3,0,0,0,0,30
1129811,35,0,0,0,0,0,0,35
1129812,40,3,0,0,0,0,0,43
1129813,0,0,0,0,0,0,0,0
1129814,70,4,0,0,0,0,0,74
1129815,45,0,0,3,0,0,0,48
1129816,31,0,0,0,0,0,0,31
1129817,35,0,4,0,0,0,0,39
1129901,35,0,6,0,0,0,0,41
1129902,41,5,3,3,0,0,0,52
1129903,36,3,0,0,0,0,0,39
1129904,25,3,3,0,3,0,0,34
1129905,12,3,4,0,0,0,3,22
1129906,15,5,0,0,0,0,0,20
1129907,22,0,0,0,0,0,0,22
1129908,19,0,0,0,0,0,0,19
1130001,53,4,8,0,0,0,3,68
1130002,61,3,3,0,0,0,0,67
1130003,31,0,3,0,0,0,0,34
1130004,47,6,6,0,0,0,0,59
1130005,43,0,0,0,0,0,0,43
1130006,42,4,0,0,0,0,0,46
1130007,47,4,0,0,0,0,0,51
1130008,0,0,0,0,0,0,0,0
1130009,26,0,4,0,0,0,0,30
1130010,45,3,3,0,0,0,0,51
1130011,41,0,0,0,0,0,0,41
1130012,32,0,0,0,0,3,0,35
1130013,39,3,0,0,0,0,0,42
1130014,39,0,0,0,0,0,3,42
1130015,24,6,3,0,0,0,0,33
1130016,63,3,6,3,0,0,0,75
1130017,35,0,0,0,0,0,0,35
1130018,56,6,4,0,0,0,0,66
1130019,74,0,7,0,0,4,0,85
1130020,24,0,0,3,0,0,0,27
1130021,29,4,0,0,0,0,0,33
1130022,71,3,3,0,0,0,0,77
1130023,57,3,3,0,0,0,0,63
1130024,37,0,4,0,0,0,0,41
1130025,39,3,6,0,0,0,0,48
1130026,48,0,4,0,0,0,0,52
1130027,39,0,0,0,0,0,0,39
1130028,44,4,0,0,0,0,0,48
1130029,70,3,3,3,0,0,0,79
1130030,18,0,0,0,0,0,0,18
1130031,55,3,4,0,0,0,0,62
1130032,38,3,0,3,0,0,0,44
1130033,48,3,3,0,0,0,0,54
1130034,48,3,3,0,0,0,0,54
1130035,65,5,0,0,0,0,0,70
1130036,49,0,4,0,0,0,0,53
1130037,59,3,3,0,0,0,3,68
1130038,45,6,0,0,0,0,0,51
1130039,0,0,0,0,0,0,0,0
1130040,35,3,3,0,0,0,0,41
1130041,65,7,4,0,0,0,0,76
1130042,71,4,4,0,0,0,0,79
1130043,75,6,0,0,0,0,0,81
1130044,40,7,3,0,0,0,0,50
1130045,38,3,3,0,0,0,0,44
1130046,27,5,0,0,0,0,0,32
1130047,66,11,4,0,0,0,0,81
1130048,51,3,3,0,0,0,0,57
1130049,58,5,3,0,0,0,0,66
1130050,50,3,3,3,0,0,0,59
1130051,52,5,4,0,0,0,0,61
1130052,45,3,3,0,0,0,3,54
1130053,41,0,3,0,0,0,0,44
1130054,59,3,0,3,0,0,0,65
1130055,30,4,5,0,0,0,0,39
1130056,48,6,0,0,0,0,0,54
1130057,12,0,3,0,0,0,0,15
1130058,40,8,3,3,0,0,0,54
1130059,10,0,0,0,0,0,0,10
1130060,28,3,0,0,0,0,0,31
1130061,17,0,0,3,0,0,0,20
1130062,66,3,3,0,0,0,0,72
1130063,43,12,0,0,0,0,0,55
1130101,39,4,3,0,0,0,0,46
1130102,27,0,0,0,0,0,0,27
1130103,39,3,0,3,0,0,0,45
1130104,92,9,3,3,0,0,0,107
1130105,38,3,3,0,0,0,0,44
1130106,54,0,0,0,0,0,0,54
1130107,63,3,4,0,0,0,0,70
1130108,40,4,0,0,0,0,0,44
1130109,81,7,0,0,0,0,0,88
1130110,67,0,4,0,0,0,0,71
1130111,40,3,0,0,0,0,0,43
1130112,51,5,0,0,0,0,0,56
1130113,27,5,3,0,0,0,0,35
1130114,48,6,0,3,0,0,0,57
1130115,69,5,0,0,0,0,0,74
1130116,78,10,3,3,0,0,3,97
1130117,56,0,3,0,0,0,0,59
1130118,88,7,4,0,0,0,0,99
1130119,62,0,3,0,0,0,0,65
1130120,58,0,0,0,0,0,0,58
1130121,59,0,0,3,0,0,0,62
1130122,42,0,0,0,0,0,0,42
1130201,77,4,4,0,0,0,0,85
1130202,52,4,4,3,0,0,0,63
1130203,74,0,3,0,0,0,0,77
1130204,126,3,10,3,0,0,0,142
1130205,111,7,0,0,0,3,0,121
1130206,93,8,3,4,0,0,4,112
1130207,31,3,3,0,0,0,0,37
1130208,61,6,3,0,0,0,0,70
1130209,47,4,3,0,0,0,0,54
1130210,60,3,3,0,0,0,0,66
1130211,75,5,5,0,0,0,0,85
1130212,64,9,3,0,0,0,0,76
1130213,36,0,3,0,0,0,0,39
1130214,90,3,3,3,0,0,0,99
1130215,89,0,3,0,0,0,0,92
1130216,59,5,0,0,0,0,0,64
1130217,63,4,3,0,0,0,0,70
1130218,44,6,0,0,0,0,0,50
1130219,122,5,0,0,0,0,0,127
1130220,55,0,4,0,0,0,0,59
1130221,42,5,0,0,0,0,0,47
1130222,75,3,0,0,0,0,0,78
1130223,55,3,4,0,0,0,0,62
1130224,75,3,3,0,0,0,0,81
1130225,56,9,0,0,0,0,0,65
1130226,80,3,3,0,0,0,0,86
1130227,64,0,7,0,0,0,0,71
1130228,73,3,0,0,0,0,3,79
1130229,68,0,4,0,0,0,0,72
1130230,65,3,5,0,0,0,0,73
1130231,91,3,3,0,0,0,0,97
1130232,58,3,3,0,0,0,0,64
1130233,54,0,3,3,0,0,0,60
1130234,54,0,4,0,0,0,0,58
1130235,75,4,0,0,0,0,0,79
1130236,61,4,3,0,0,0,0,68
1130237,71,9,6,0,0,0,0,86
1130238,63,3,5,0,0,0,0,71
1130239,0,0,0,0,0,0,0,0
1130240,67,0,5,0,0,0,3,75
1130241,60,0,4,0,0,0,0,64
1130242,48,3,0,0,0,0,0,51
1130243,79,10,0,0,0,0,0,89
1130244,35,5,0,0,0,0,0,40
1130301,26,0,0,0,0,0,0,26
1130302,31,0,0,0,0,0,0,31
1130303,0,0,0,0,0,0,0,0
1130304,47,5,0,0,0,0,0,52
1130305,43,0,3,0,3,0,0,49
1130306,57,3,3,3,0,0,0,66
1130307,47,4,3,0,0,0,3,57
1130308,81,0,0,0,0,0,0,81
1130309,0,0,0,0,0,0,0,0
1130310,48,5,0,0,0,0,3,56
1130311,60,6,5,0,0,0,0,71
1130312,53,3,0,0,0,0,0,56
1130313,0,0,0,0,0,0,0,0
1130314,52,3,3,0,0,0,0,58
1130315,73,0,3,0,0,0,0,76
1130316,30,3,0,0,0,0,0,33
1130317,37,5,3,0,0,0,0,45
1130318,36,3,0,3,0,0,0,42
1130319,79,3,3,0,0,0,0,85
1130320,59,3,0,3,0,0,0,65
1130321,27,0,0,0,0,0,0,27
1130322,43,0,3,0,0,0,0,46
1130323,42,3,7,0,0,0,0,52
1130324,50,4,3,0,0,0,0,57
1130325,57,3,0,7,0,0,0,67
1130326,34,0,0,0,0,0,0,34
1130327,44,4,0,0,0,0,0,48
1130328,95,3,4,0,0,0,0,102
1130329,53,0,3,0,0,0,0,56
1130330,0,0,0,0,0,0,0,0
1130331,119,5,0,0,0,0,0,124
1130332,7,0,0,4,0,0,0,11
1130333,71,5,0,0,0,0,0,76
1130334,66,0,0,0,0,0,0,66
1130335,64,4,0,0,0,0,0,68
1130336,33,6,3,0,0,0,0,42
1130337,0,0,0,0,0,0,0,0
1130338,51,3,3,0,0,3,0,60
1130339,27,0,0,0,0,0,0,27
1130340,0,0,0,0,0,0,0,0
1130341,45,3,0,0,0,0,0,48
1130342,37,4,0,0,0,0,0,41
1130401,45,0,4,0,0,0,0,49
1130402,47,3,3,0,0,0,0,53
1130403,58,3,0,3,0,0,0,64
1130404,58,4,7,0,0,0,0,69
1130405,40,0,0,0,3,0,0,43
1130406,49,0,0,3,0,0,0,52
1130407,41,9,0,0,0,0,0,50
1130408,33,3,3,3,0,0,0,42
1130409,43,6,0,0,0,0,0,49
1130410,44,4,3,0,0,0,0,51
1130411,34,3,3,3,0,0,0,43
1130412,33,0,0,3,0,0,0,36
1130413,55,3,3,3,0,0,0,64
1130414,42,0,3,0,0,0,0,45
1130415,40,4,0,5,0,0,0,49
1130416,77,0,5,0,0,0,0,82
1130417,75,6,3,0,0,0,0,84
1130418,83,5,3,0,0,0,0,91
1130419,55,0,3,0,0,0,0,58
1130420,57,3,0,3,0,0,0,63
1130421,50,4,3,0,0,0,0,57
1130422,37,3,0,0,0,0,0,40
1130423,23,3,3,0,0,0,0,29
1130424,99,4,0,0,0,0,0,103
1130425,41,5,3,0,3,0,0,52
1130426,67,3,3,0,0,0,0,73
1130427,0,0,0,0,0,0,0,0
1130428,36,8,0,0,0,0,0,44
1130429,26,0,3,3,3,0,0,35
1130430,41,0,0,0,0,0,0,41
1130431,20,5,0,0,0,0,0,25
1130432,71,4,3,0,0,0,0,78
1130433,57,3,0,0,0,0,0,60
1130434,67,3,3,0,0,0,0,73
1130435,64,5,5,0,0,0,0,74
1130436,50,9,0,0,0,0,0,59
1130437,56,4,0,0,0,0,0,60
1130438,39,0,4,0,0,0,0,43
1130439,51,4,0,0,0,0,0,55
1130440,46,0,0,0,0,0,0,46
1130441,0,0,0,0,0,0,0,0
1130442,45,3,0,3,0,0,0,51
1130501,61,3,0,3,0,0,0,67
1130502,41,5,3,0,0,0,0,49
1130503,49,3,5,4,0,0,0,61
1130504,34,3,7,0,0,0,0,44
1130505,48,3,3,0,0,0,0,54
1130506,96,3,3,0,0,0,0,102
1130507,47,4,0,0,0,0,0,51
1130508,46,3,3,0,0,0,0,52
1130509,99,3,5,3,0,0,0,110
1130510,51,3,0,0,0,0,3,57
1130511,48,8,3,0,0,0,0,59
1130512,32,3,0,8,0,0,0,43
1130513,49,3,0,0,0,0,0,52
1130514,53,7,3,0,0,0,0,63
1130515,34,0,0,3,0,0,0,37
1130516,51,4,3,5,0,0,0,63
1130517,80,3,3,0,0,0,0,86
1130518,44,0,0,0,0,0,0,44
1130519,51,3,3,0,0,0,0,57
1130520,23,0,0,0,0,0,0,23
1130521,55,5,3,5,0,0,4,72
1130522,42,0,0,4,0,0,0,46
1130523,36,0,3,3,0,0,0,42
1130524,80,5,3,0,0,0,0,88
1130525,25,0,0,0,0,0,0,25
1130526,18,3,0,3,0,0,0,24
1130527,75,5,0,0,0,0,0,80
1130528,62,3,0,0,0,0,0,65
1130529,52,4,3,0,0,0,0,59
1130530,38,4,0,0,3,0,0,45
1130531,39,3,3,0,0,0,0,45
1130532,33,7,0,0,0,0,0,40
1130533,43,3,3,0,0,0,0,49
1130534,78,4,4,0,0,0,0,86
1130535,48,0,0,3,0,0,0,51
1130536,58,3,0,3,0,0,0,64
1130537,61,0,0,0,0,0,0,61
1130538,83,3,3,0,0,0,0,89
1130539,54,3,3,0,0,0,3,63
1130540,41,4,4,0,0,0,0,49
1130541,49,0,0,0,0,0,0,49
1130542,83,3,3,3,0,0,0,92
1130543,46,4,3,0,0,0,0,53
1130544,40,0,0,0,0,0,0,40
1130545,45,0,0,3,0,0,0,48
1130546,46,0,0,3,0,0,0,49
1130547,55,4,3,3,0,0,0,65
1130548,56,0,3,0,0,0,0,59
1130549,62,4,3,0,0,0,0,69
1130550,66,0,0,3,0,0,0,69
1130551,53,3,0,0,0,0,0,56
1130552,26,0,0,0,0,0,0,26
1130553,40,3,0,0,0,0,0,43
1130554,54,4,0,0,0,0,0,58
1130555,73,6,3,0,0,0,0,82
1130556,63,8,0,0,0,0,0,71
1130557,73,4,0,0,0,0,0,77
1130558,54,0,3,0,0,0,4,61
1130559,95,0,4,0,0,0,0,99
1130560,19,3,0,0,0,0,3,25
1130561,69,6,0,3,0,0,0,78
1130562,42,5,4,0,0,0,0,51
1130563,79,5,3,3,0,0,0,90
1130601,94,5,3,3,3,0,0,108
1130602,80,0,3,3,0,0,0,86
1130603,215,3,3,3,0,0,0,224
1130604,0,0,0,0,0,0,0,0
1130605,8,0,3,0,0,0,3,14
1130606,50,0,3,0,0,0,0,53
1130607,33,0,5,0,0,0,0,38
1130608,78,8,3,3,0,0,3,95
1130609,23,0,0,3,3,0,0,29
1130610,38,0,4,0,0,0,0,42
1130611,81,6,0,0,0,0,0,87
1130612,71,0,0,0,0,0,0,71
1130613,68,3,3,0,0,0,0,74
1130614,52,0,0,3,0,0,0,55
1130615,77,3,0,0,0,0,0,80
1130616,48,0,0,0,0,0,0,48
1130617,79,3,0,0,0,0,0,82
1130618,57,4,3,0,0,0,0,64
1130619,91,0,0,3,0,0,0,94
1130620,82,7,4,4,0,0,0,97
1130621,62,9,4,0,0,0,0,75
1130622,64,0,4,0,0,0,0,68
1130623,19,3,3,0,3,0,3,31
1130624,46,5,5,0,0,0,0,56
1130625,50,3,4,0,0,0,0,57
1130626,46,5,0,0,0,0,4,55
1130627,26,0,3,0,0,3,0,32
1130628,43,0,3,0,0,0,0,46
1130629,3,0,0,0,0,0,0,3
1130630,66,8,0,0,0,0,0,74
1130631,55,3,0,0,0,0,4,62
1130632,28,6,3,0,0,0,0,37
1130633,27,0,8,0,0,0,0,35
1130634,32,3,0,3,0,0,0,38
1130635,29,3,0,3,0,0,0,35
1130636,36,3,3,0,0,0,0,42
1130637,42,0,3,0,0,0,0,45
1130638,46,9,0,0,0,0,0,55
1130639,50,4,3,0,3,0,3,63
1130640,46,3,3,3,0,0,0,55
1130641,55,0,3,4,0,0,0,62
1130642,46,3,0,4,0,0,0,53
1130643,20,0,3,0,0,0,0,23
1130644,23,0,0,0,0,0,0,23
1130645,20,3,0,0,0,0,0,23
1130646,67,3,3,3,0,0,0,76
1130647,26,3,3,0,0,0,4,36
1130648,34,3,0,0,0,0,0,37
1130649,26,3,4,4,0,0,0,37
1130650,57,0,4,0,0,0,3,64
1130701,68,5,3,0,0,0,0,76
1130702,61,0,0,0,0,0,0,61
1130703,82,0,0,0,0,0,0,82
1130704,33,3,0,0,0,0,0,36
1130705,40,3,3,3,0,0,0,49
1130706,41,0,5,0,0,0,0,46
1130707,41,5,3,3,0,0,0,52
1130708,37,0,3,0,0,0,0,40
1130709,48,3,3,0,0,0,0,54
1130710,50,3,3,0,0,0,0,56
1130711,75,4,0,3,0,0,0,82
1130712,62,3,0,0,0,0,0,65
1130713,48,3,0,3,0,0,0,54
1130714,79,3,4,0,0,0,0,86
1130715,44,0,4,0,0,0,0,48
1130716,48,0,4,0,0,0,0,52
1130717,54,3,3,3,0,0,0,63
1130718,34,3,3,0,0,0,0,40
1130719,42,0,3,5,0,0,0,50
1130720,66,5,3,0,0,0,0,74
1130721,0,0,0,0,0,0,0,0
1130722,51,4,0,0,0,0,0,55
1130723,63,3,0,3,0,0,3,72
1130724,37,4,0,0,0,0,0,41
1130725,65,3,3,0,0,0,0,71
1130726,84,10,0,0,0,0,0,94
1130727,41,3,0,0,0,0,0,44
1130728,10,0,3,0,0,0,0,13
1130729,45,5,0,0,0,0,3,53
1130730,66,3,0,0,0,0,0,69
1130731,66,3,0,0,0,0,0,69
1130732,35,0,6,3,0,0,0,44
1130733,49,4,0,0,0,0,0,53
1130734,53,3,0,0,0,3,0,59
1130735,56,0,0,0,0,0,0,56
1130736,58,6,3,4,0,0,3,74
1130737,29,3,0,0,0,0,0,32
1130738,50,3,3,0,0,0,0,56
1130739,42,4,3,3,3,0,0,55
1130740,47,3,0,5,0,0,0,55
1130741,43,5,4,0,0,0,0,52
1130742,62,0,3,0,0,0,0,65
1130743,41,5,0,0,0,0,0,46
1130744,88,4,5,0,0,0,0,97
1130745,81,4,5,4,0,0,0,94
1130746,66,0,3,0,0,0,0,69
1130747,60,8,3,0,0,0,0,71
1130748,48,5,3,3,0,0,3,62
1130749,43,3,7,0,0,3,0,56
1130750,75,5,0,0,0,0,0,80
1130751,54,3,3,0,0,0,0,60
1130752,61,7,0,0,0,0,0,68
1130753,67,0,0,0,0,0,0,67
1130754,57,3,5,3,0,0,0,68
1130755,56,3,0,0,0,0,0,59
1130756,50,4,3,3,0,0,0,60
1130801,36,0,3,3,0,0,0,42
1130802,69,3,3,3,0,0,0,78
1130803,57,4,4,0,0,0,0,65
1130804,39,3,0,0,0,0,0,42
1130805,67,3,3,4,0,0,0,77
1130806,50,4,0,0,0,0,0,54
1130807,62,4,3,0,0,0,0,69
1130808,35,3,3,0,0,3,0,44
1130809,61,4,3,3,0,0,0,71
1130810,69,3,3,0,0,0,0,75
1130811,25,5,4,0,0,0,0,34
1130812,58,3,3,0,0,0,0,64
1130813,71,3,3,3,0,0,0,80
1130814,79,0,0,3,0,0,0,82
1130815,63,7,0,3,0,0,0,73
1130816,50,3,3,3,0,0,0,59
1130817,51,0,0,0,0,0,0,51
1130818,3,3,0,0,0,0,3,9
1130819,49,4,0,0,0,0,0,53
1130820,87,3,3,0,0,0,3,96
1130821,64,5,4,3,0,0,0,76
1130822,41,3,0,3,0,0,0,47
1130823,87,0,0,0,0,0,0,87
1130824,29,8,4,0,0,0,0,41
1130825,31,3,3,0,0,0,0,37
1130826,65,0,0,0,0,0,0,65
1130827,82,0,4,0,0,0,0,86
1130828,71,3,3,3,0,0,0,80
1130829,98,4,4,3,0,0,0,109
1130830,45,7,0,3,0,0,0,55
1130831,42,0,0,0,0,0,0,42
1130832,82,3,3,3,0,0,0,91
1130833,79,0,0,4,0,0,0,83
1130834,70,3,0,0,0,0,0,73
1130835,60,0,0,0,0,0,0,60
1130836,49,5,3,0,0,0,0,57
1130837,58,3,3,0,0,0,0,64
1130838,70,3,3,3,0,0,0,79
1130839,52,0,3,3,0,0,0,58
1130840,43,5,0,0,0,0,0,48
1130841,0,0,0,0,0,0,0,0
1130842,73,6,3,0,0,0,0,82
1130843,68,10,3,0,0,0,0,81
1130844,79,4,4,0,0,0,0,87
1130845,84,6,4,0,0,0,0,94
1130846,85,3,0,0,0,0,0,88
1130847,57,3,3,0,0,0,0,63
1130848,66,4,6,0,0,0,0,76
1130849,75,6,0,0,0,0,0,81
1130850,55,5,0,0,0,0,0,60
1130851,44,0,0,3,0,0,0,47
1130901,71,7,3,3,0,0,0,84
1130902,65,3,0,7,0,0,0,75
1130903,59,0,6,0,0,0,0,65
1130904,71,3,3,3,0,0,0,80
1130905,64,3,3,3,0,0,0,73
1130906,85,10,0,3,0,0,0,98
1130907,56,3,3,3,0,0,0,65
1130908,59,3,0,0,0,0,0,62
1130909,49,3,3,0,0,0,0,55
1130910,70,3,4,0,0,0,0,77
1130911,62,0,0,4,0,0,0,66
1130912,89,6,0,0,0,0,0,95
1130913,48,0,0,0,0,0,0,48
1130914,95,3,5,3,0,0,0,106
1130915,50,0,6,3,0,0,0,59
1130916,46,3,3,0,0,0,0,52
1130917,56,0,3,0,0,0,0,59
1130918,99,3,7,4,0,0,0,113
1130919,111,4,0,0,0,0,0,115
1130920,44,5,3,4,0,3,0,59
1130921,57,3,0,0,0,0,0,60
1130922,125,4,0,3,0,0,3,135
1130923,67,4,0,0,0,0,0,71
1130924,128,3,3,3,0,0,0,137
1130925,86,3,8,0,0,0,0,97
1130926,39,3,3,0,0,0,0,45
1130927,47,3,0,0,0,0,0,50
1130928,84,3,3,3,0,0,0,93
1130929,77,4,0,0,0,0,0,81
1130930,85,4,3,0,0,0,0,92
1130931,85,6,3,0,0,0,0,94
1130932,59,3,0,3,0,0,0,65
1130933,41,0,0,0,0,0,0,41
1130934,69,0,3,0,0,0,0,72
1130935,48,3,3,3,0,3,0,60
1130936,45,4,3,3,0,0,0,55
1131001,185,12,9,3,0,0,3,212
1131002,99,3,6,0,0,0,0,108
1131003,329,6,10,4,0,0,0,349
1131004,77,5,3,0,0,0,0,85
1131005,92,10,0,0,0,0,0,102
1131006,44,0,3,0,0,0,0,47
1131007,42,0,0,0,0,0,0,42
1131008,61,6,0,0,0,0,0,67
1131009,158,4,9,4,0,0,0,175
1131010,187,7,7,3,0,0,0,204
1131011,47,0,0,0,0,0,0,47
1131012,6,0,0,0,0,0,0,6
1131013,65,3,4,0,0,0,0,72
1131014,63,7,4,0,0,0,0,74
1131015,55,0,3,4,0,0,0,62
1131016,174,10,6,3,0,0,0,193
1131017,86,6,0,0,0,0,0,92
1131018,97,3,8,0,0,0,0,108
1131019,85,4,3,3,0,0,3,98
1131020,80,3,3,0,0,0,4,90
1131021,53,0,0,0,0,0,0,53
1131022,53,5,0,0,0,0,0,58
1131023,179,8,8,4,0,0,0,199
1131024,0,0,0,0,0,0,0,0
1131025,90,3,3,0,0,0,0,96
1131026,243,15,7,3,0,0,0,268
1131027,90,3,0,3,0,0,0,96
1131028,295,29,8,3,0,3,0,338
1131029,151,8,3,0,0,0,0,162
1131030,76,9,3,0,0,0,0,88
1131031,252,15,6,3,0,0,0,276
1131101,93,5,6,0,0,0,0,104
1131102,81,4,0,0,0,0,0,85
1131103,129,0,8,0,0,0,0,137
1131104,95,7,0,3,0,0,0,105
1131105,73,0,6,0,0,0,0,79
1131106,34,0,3,0,0,0,0,37
1131107,55,5,0,0,0,0,0,60
1131108,72,0,0,0,0,0,0,72
1131109,72,9,0,0,0,0,0,81
1131110,65,8,4,3,0,0,0,80
1131111,44,0,5,0,0,0,0,49
1131112,83,4,4,0,0,0,0,91
1131113,7,0,0,0,0,0,0,7
1131114,85,3,3,4,0,0,3,98
1131115,88,3,0,0,0,0,0,91
1131116,137,11,0,0,0,0,0,148
1131117,69,5,0,0,0,0,0,74
1131118,86,3,0,0,0,0,0,89
1131119,50,0,4,0,0,0,0,54
1131120,65,7,3,3,0,0,0,78
1131121,70,5,0,0,0,0,0,75
1131122,59,4,4,0,0,0,0,67
1131123,69,6,0,0,0,0,0,75
1131124,89,4,6,0,0,0,0,99
1131125,56,6,0,0,0,0,0,62
1131126,52,5,0,0,0,0,0,57
1131127,63,7,0,0,0,0,0,70
1131128,47,3,0,0,0,0,0,50
1131129,61,0,0,0,0,0,0,61
1131130,51,3,0,0,0,0,0,54
1131131,67,4,8,0,0,0,0,79
1131132,39,4,4,0,0,0,0,47
1131133,79,3,0,0,0,0,0,82
1131134,22,3,3,0,0,0,0,28
1131135,53,0,0,0,0,0,0,53
1131136,43,0,3,0,0,0,3,49
1131137,64,5,3,0,0,0,0,72
1131138,73,0,5,0,0,0,0,78
1131139,63,3,3,5,0,0,0,74
1131140,84,5,3,0,0,0,0,92
1131141,40,5,4,0,0,0,0,49
1131142,44,4,4,0,0,0,0,52
1131143,52,3,3,0,0,0,0,58
1131144,65,0,3,3,0,0,0,71
1131145,94,5,0,0,0,0,0,99
1131146,56,3,3,0,0,0,0,62
1131147,57,0,0,0,0,0,0,57
1131148,49,3,0,0,0,0,0,52
1131149,47,4,0,0,0,0,0,51
1131150,63,0,4,0,0,0,4,71
1131151,94,3,5,0,0,0,0,102
1131152,70,3,3,0,0,0,0,76
1131153,85,8,0,0,0,0,0,93
1131154,45,4,3,0,0,0,0,52
1131155,74,8,3,0,0,0,0,85
1131156,74,0,4,0,0,0,0,78
1131157,87,3,3,0,0,0,0,93
1131158,118,9,8,3,0,0,0,138
1131201,22,3,0,0,0,0,3,28
1131202,55,4,3,0,0,0,0,62
1131203,20,0,0,0,0,0,0,20
1131204,35,3,3,0,0,0,0,41
1131205,42,4,0,0,0,0,0,46
1131206,30,0,0,0,0,0,0,30
1131207,33,4,5,0,0,0,0,42
1131208,45,7,0,0,0,0,0,52
1131209,45,3,3,3,0,0,0,54
1131210,54,0,5,0,0,0,3,62
1131211,31,0,0,0,0,0,0,31
1131212,18,3,0,0,0,0,0,21
1131213,33,4,4,3,0,0,0,44
1131214,40,9,4,0,0,0,0,53
1131215,52,7,6,0,0,0,0,65
1131216,29,0,4,0,0,0,0,33
1131217,65,4,0,0,0,0,0,69
1131218,30,4,4,0,0,0,0,38
1131219,28,5,3,0,0,0,0,36
1131220,43,8,4,0,0,0,0,55
1131221,0,0,0,0,0,0,0,0
1131222,50,0,3,0,0,0,0,53
1131223,33,0,3,0,0,0,0,36
1131224,32,3,0,0,0,0,0,35
1131225,0,0,0,0,0,0,0,0
1131226,78,7,3,0,0,0,0,88
1131227,46,7,0,0,0,0,0,53
1131228,31,3,0,0,0,0,0,34
1131229,25,3,3,0,0,0,0,31
1131230,29,3,3,0,3,0,0,38
1131231,38,4,4,0,0,0,0,46
1131232,57,4,0,0,0,0,0,61
1131233,51,5,4,0,0,0,0,60
1131301,11,3,3,0,0,0,0,17
1131302,20,3,3,3,0,0,0,29
1131303,31,3,6,0,0,0,3,43
1131304,31,7,3,0,0,0,0,41
1131305,50,4,4,5,0,0,0,63
1131306,33,5,3,0,0,0,0,41
1131307,35,4,3,3,0,0,0,45
1131308,22,0,0,0,0,0,0,22
1131309,26,6,3,0,0,0,0,35
1131310,51,3,5,0,0,0,0,59
1131311,13,3,3,3,3,0,0,25
1131312,16,3,0,5,0,0,0,24
1131313,25,3,0,0,0,0,0,28
1131314,39,3,3,3,0,0,0,48
1131315,17,3,0,3,0,0,3,26
1131316,18,3,0,0,0,0,0,21
1131317,29,3,3,3,0,0,0,38
1131318,30,4,5,3,0,0,0,42
1131319,28,3,3,0,0,0,0,34
1131320,50,3,3,3,0,0,0,59
1131321,16,0,0,0,0,0,0,16
1131322,21,4,8,0,0,0,0,33
1131323,10,3,3,0,0,0,0,16
1131324,0,0,0,0,0,0,0,0
1131325,41,0,4,4,0,0,4,53
1131326,24,0,0,0,0,0,0,24
1131327,68,3,8,4,0,0,0,83
1131328,67,12,0,3,0,0,0,82
1131329,0,0,0,0,0,0,0,0
1131330,18,0,5,0,0,0,0,23
1131331,0,0,0,0,0,0,0,0
1131332,35,5,0,0,0,0,0,40
1131333,32,4,4,0,0,0,0,40
1131334,28,3,0,0,0,0,0,31
1131335,54,0,5,3,0,0,0,62
1131336,45,8,4,8,0,0,0,65
1131337,28,0,0,0,0,0,0,28
1131338,40,7,0,3,0,0,0,50
1131339,26,0,3,0,0,0,0,29
1131340,14,3,3,3,0,0,0,23
1131341,27,3,0,0,3,0,0,33
1131342,37,5,0,0,0,0,0,42
1131343,12,3,5,0,0,0,0,20
1131344,0,0,0,0,0,0,0,0
1131345,34,4,3,0,0,0,0,41
1131346,26,4,0,0,0,0,0,30
1131347,50,0,3,3,0,0,0,56
1131348,43,8,3,0,0,0,0,54
1131349,61,5,0,0,0,0,0,66
1131350,56,4,7,3,0,0,0,70
1131351,41,9,3,0,0,0,0,53
1131352,16,0,5,0,0,0,0,21
1131401,67,3,6,0,0,0,0,76
1131402,84,6,4,0,0,0,0,94
1131403,59,3,6,0,0,0,0,68
1131404,64,6,3,0,0,0,0,73
1131405,82,3,3,3,0,0,0,91
1131406,63,4,3,0,0,0,0,70
1131407,70,0,6,0,0,0,0,76
1131408,73,3,3,0,0,0,0,79
1131409,54,4,0,0,0,0,0,58
1131410,42,3,0,0,0,0,0,45
1131411,84,5,5,0,0,0,0,94
1131412,47,4,9,0,0,0,0,60
1131413,44,6,0,0,0,0,0,50
1131414,36,5,3,0,0,0,0,44
1131415,54,3,3,3,0,0,0,63
1131416,26,3,0,0,0,0,0,29
1131417,60,0,6,0,0,0,0,66
1131418,0,0,0,0,0,0,0,0
1131419,51,0,0,3,0,3,0,57
1131420,0,0,0,0,0,0,0,0
1131421,0,0,0,0,0,0,0,0
1131422,66,0,0,0,0,0,0,66
1131423,60,0,0,0,0,0,0,60
1131501,51,8,4,0,0,0,0,63
1131502,62,5,0,0,0,0,0,67
1131503,33,3,4,0,0,0,0,40
1131504,82,7,4,0,0,0,0,93
1131505,87,0,0,0,0,0,0,87
1131506,103,5,4,0,0,0,0,112
1131507,0,0,0,0,0,0,0,0
1131508,50,3,3,3,0,0,0,59
1131509,34,3,3,0,0,0,3,43
1131510,49,3,3,0,0,0,3,58
1131511,42,0,3,3,0,0,0,48
1131512,90,0,0,0,0,0,0,90
1131513,60,5,3,3,0,0,0,71
1131514,90,9,3,0,0,0,0,102
1131515,64,5,3,0,0,0,0,72
1131516,90,0,9,0,0,0,0,99
1131517,72,0,5,0,0,0,0,77
1131518,58,4,3,3,0,3,0,71
1131519,52,5,0,0,0,0,0,57
1131520,93,5,0,0,0,0,0,98
1131521,55,4,5,0,0,0,0,64
1131522,67,5,4,5,0,0,0,81
1131523,84,5,0,4,0,0,0,93
1131524,69,6,3,5,0,0,0,83
1131525,73,0,3,0,0,0,0,76
1131526,29,0,3,3,0,0,0,35
1131527,65,5,3,0,0,0,0,73
1131528,56,0,0,3,0,0,0,59
1131529,67,8,5,0,0,0,0,80
1131530,67,4,4,0,0,0,0,75
1131531,42,3,3,3,0,0,0,51
1131532,68,3,3,0,0,0,0,74
1131533,76,7,3,0,0,0,0,86
1131534,42,0,3,0,0,0,0,45
1131535,84,0,6,0,0,0,0,90
1131536,34,0,0,0,0,0,0,34
1131537,84,8,4,0,0,0,0,96
1131538,52,5,4,0,0,0,0,61
1131539,69,0,3,0,0,0,0,72
1131540,54,3,3,3,0,0,0,63
1131541,48,0,0,0,3,0,0,51
1131542,69,3,3,3,0,0,0,78
1131543,70,3,0,0,3,0,0,76
1131544,84,0,3,0,0,0,4,91
1131545,49,3,0,0,0,0,0,52
1131546,71,0,0,0,0,0,3,74
1131601,0,0,0,0,0,0,0,0
1131602,12,3,3,0,0,0,0,18
1131603,15,3,0,0,0,0,0,18
1131604,202,12,10,3,0,0,0,227
1131605,35,4,3,0,0,0,0,42
1131606,34,6,5,3,0,0,0,48
1131607,26,9,3,0,0,0,0,38
1131608,26,0,4,0,0,0,3,33
1131609,19,3,4,3,0,0,0,29
1131610,30,0,3,0,0,0,3,36
1131611,24,0,0,0,0,0,0,24
1131612,24,0,6,0,0,0,0,30
1131613,36,3,0,0,0,0,0,39
1131614,30,0,3,0,0,0,0,33
1131615,29,3,0,3,0,0,0,35
1131616,26,0,4,0,0,0,0,30
1131617,41,3,6,0,0,0,0,50
1131618,32,0,0,0,0,0,0,32
1131619,22,3,3,3,0,0,0,31
1131620,27,4,0,0,0,0,0,31
1131621,21,0,0,0,0,0,0,21
1131622,40,4,7,0,3,0,0,54
1131623,69,5,6,0,0,3,0,83
1131624,26,7,0,0,0,0,0,33
1131625,9,4,6,0,0,0,0,19
1131626,40,3,0,3,0,0,0,46
1131627,17,4,3,0,0,0,3,27
1131628,16,0,3,0,3,0,0,22
1131629,16,3,4,0,0,0,0,23
1131630,39,6,0,0,0,0,0,45
1131631,23,3,3,0,0,0,0,29
1131632,32,5,4,0,0,0,0,41
1131633,23,3,3,0,0,0,3,32
1131634,36,5,4,0,0,0,3,48
1131635,11,0,4,0,0,0,0,15
1131636,21,8,3,0,0,0,0,32
1131637,0,0,0,0,0,0,0,0
1131638,22,7,0,0,0,0,3,32
1131639,30,3,3,5,0,0,0,41
1131640,33,0,7,0,0,0,0,40
1131641,32,0,0,0,0,0,0,32
1131701,3,0,0,0,0,0,0,3
1131702,56,4,0,6,0,0,0,66
1131703,58,3,3,0,0,0,0,64
1131704,99,4,0,0,0,0,0,103
1131705,40,0,0,3,0,0,0,43
1131706,34,0,0,0,0,0,3,37
1131707,42,7,6,0,0,0,0,55
1131708,34,0,3,0,0,3,0,40
1131709,36,3,3,0,0,0,0,42
1131710,54,8,3,0,0,0,3,68
1131711,74,3,3,0,0,0,0,80
1131712,47,3,3,0,0,0,0,53
1131713,0,0,0,0,0,0,0,0
1131714,34,4,4,3,0,0,0,45
1131715,35,5,4,0,0,0,0,44
1131716,0,0,0,0,0,0,0,0
1131717,73,7,5,0,0,0,0,85
1131718,58,0,0,5,0,0,0,63
1131719,76,3,3,3,0,0,0,85
1131720,56,4,5,0,0,0,0,65
1131721,56,0,3,3,0,0,0,62
1131722,66,8,8,0,0,0,0,82
1131723,16,3,0,0,0,0,3,22
1131724,40,0,0,0,0,0,0,40
1131725,31,9,0,0,0,0,0,40
1131726,47,5,3,3,0,0,3,61
1131727,24,3,7,0,0,0,6,40
1131728,57,3,3,3,0,0,0,66
1131729,33,3,0,3,0,0,0,39
1131730,64,5,3,0,0,0,0,72
1131731,56,3,3,0,0,0,0,62
1131732,24,3,3,0,0,0,0,30
1131733,32,3,3,0,0,0,0,38
1131734,62,6,0,0,0,0,0,68
1131735,85,7,3,0,0,0,3,98
1131736,48,0,3,0,0,0,3,54
1131737,63,0,3,3,0,0,0,69
1131738,71,0,0,0,0,0,0,71
1131739,63,7,4,0,0,0,3,77
1131740,73,0,4,0,0,0,0,77
1131741,76,6,3,0,0,0,0,85
1131742,70,8,4,0,0,0,0,82
1131743,86,6,3,0,0,0,0,95
1131744,72,3,3,3,0,0,0,81
1131745,111,7,0,6,0,0,0,124
1131746,91,0,0,0,3,0,0,94
1131801,0,0,0,0,0,0,0,0
1131802,0,0,0,0,0,0,0,0
1131803,0,0,0,0,0,0,0,0
1131901,55,4,3,0,0,0,0,62
1131902,50,3,3,0,0,0,0,56
1131903,57,0,3,0,0,0,0,60
1131904,28,3,4,0,0,0,0,35
1131905,58,3,0,4,0,0,0,65
1131906,46,5,0,0,0,0,0,51
1131907,48,0,3,0,0,0,0,51
1131908,61,8,0,0,0,0,0,69
1131909,73,5,8,0,0,0,0,86
1131910,0,0,0,0,0,0,0,0
1131911,0,4,0,0,0,0,0,4
1131912,43,3,0,0,0,0,0,46
1131913,98,4,3,0,0,0,0,105
1131914,87,3,3,3,0,0,0,96
1131915,45,7,3,0,0,0,0,55
1131916,60,4,0,0,0,0,0,64
1131917,60,7,4,0,0,0,0,71
1131918,51,4,0,3,0,0,0,58
1131919,25,0,0,0,0,0,0,25
1131920,3,0,0,0,0,0,0,3
1131921,70,4,0,3,0,0,0,77
1131922,51,5,3,4,0,0,0,63
1131923,53,3,0,3,0,0,0,59
1131924,33,4,3,3,0,0,0,43
1131925,46,0,0,0,0,0,3,49
1131926,48,4,3,0,0,0,0,55
1131927,48,5,4,0,0,0,0,57
1131928,83,4,4,4,0,0,0,95
1131929,67,0,6,0,0,0,0,73
1131930,36,3,0,0,0,0,0,39
1131931,101,7,3,3,0,0,0,114
1131932,37,8,6,3,0,0,0,54
1131933,41,0,0,0,0,0,0,41
1131934,52,4,4,0,0,0,0,60
1131935,76,3,6,7,0,0,0,92
1131936,54,3,3,0,0,0,0,60
1131937,102,4,0,0,0,3,0,109
1131938,54,3,0,0,0,0,0,57
1131939,64,3,0,0,0,0,0,67
1131940,57,3,0,0,0,0,0,60
1131941,59,6,0,4,0,0,0,69
1131942,58,3,3,0,0,0,0,64
1131943,41,3,3,0,0,0,0,47
1131944,50,0,0,0,0,0,0,50
1131945,56,0,3,0,0,0,3,62
1131946,74,8,0,0,0,0,0,82
1131947,58,4,0,0,0,0,0,62
1131948,80,4,4,0,0,0,0,88
1132001,0,0,0,0,0,0,0,0
1132002,0,0,0,0,0,0,0,0
1132003,0,0,0,0,0,0,0,0
1132101,111,3,5,0,0,0,0,119
1132102,21,0,0,0,0,0,0,21
1132103,56,4,0,0,0,0,0,60
1132104,66,0,3,0,0,0,0,69
1132105,43,3,0,0,0,0,0,46
1132106,44,5,0,4,0,0,0,53
1132107,103,7,4,3,0,0,0,117
1132108,54,3,3,0,0,0,0,60
1132109,49,3,3,0,0,0,0,55
1132110,45,3,3,0,0,0,0,51
1132111,80,3,4,0,0,0,0,87
1132112,64,3,0,5,0,0,0,72
1132113,57,3,0,4,0,0,0,64
1132114,58,6,3,3,0,0,0,70
1132115,29,4,3,0,0,0,0,36
1132116,36,3,0,0,0,0,0,39
1132117,30,0,0,0,0,0,0,30
1132118,44,5,5,0,0,0,0,54
1132119,99,3,3,3,0,0,0,108
1132120,3,0,3,0,0,0,0,6
1132121,0,0,0,0,0,0,0,0
1132122,0,0,0,0,0,0,0,0
1132123,0,0,0,0,0,0,0,0
1132201,60,6,0,0,0,0,0,66
1132202,37,0,3,0,0,0,0,40
1132203,52,0,3,0,0,0,0,55
1132204,40,3,3,0,0,0,0,46
1132205,45,3,0,0,0,0,0,48
1132206,34,3,0,0,0,0,0,37
1132207,25,0,0,3,0,0,0,28
1132208,41,3,0,0,3,0,0,47
1132209,69,3,0,0,0,0,0,72
1132210,43,3,4,0,0,0,0,50
1132211,68,4,3,0,0,0,0,75
1132212,38,0,0,0,0,0,0,38
1132213,50,5,3,0,0,0,0,58
1132214,30,3,0,3,0,0,0,36
1132215,55,9,3,0,0,0,0,67
1132216,61,4,3,0,0,0,0,68
1132217,0,0,0,0,0,0,0,0
1132218,55,5,0,0,0,0,0,60
1132219,89,5,0,0,0,0,0,94
1132220,9,0,0,0,0,0,0,9
1132221,71,3,3,3,0,0,0,80
1132222,44,0,0,0,0,0,0,44
1132223,53,3,0,0,0,0,0,56
1132224,22,0,0,0,0,0,0,22
1132225,36,0,0,0,0,0,0,36
1132226,34,3,0,3,0,0,0,40
1132227,89,4,0,3,0,0,0,96
1132228,48,0,3,0,0,0,0,51
1132229,51,8,3,0,0,0,0,62
1132230,35,0,0,0,0,0,0,35
1132231,61,0,0,0,0,0,0,61
1132232,22,3,0,0,0,0,0,25
1132233,46,0,0,0,0,0,0,46
1132234,64,5,3,0,0,0,0,72
1132235,68,0,0,0,0,0,0,68
1132236,66,6,3,0,0,0,0,75
1132237,61,3,3,0,0,0,0,67
1132238,59,3,3,0,0,0,0,65
1132239,70,3,0,6,0,0,0,79
1132240,50,0,0,0,0,0,0,50
1132241,50,0,0,0,0,0,0,50
1132242,40,4,0,0,0,0,0,44
1132243,31,0,0,0,0,0,0,31
1132244,64,6,0,0,0,0,0,70
1132245,36,0,0,0,0,0,0,36
1132246,44,3,0,0,0,0,0,47
1132247,46,0,0,0,0,0,0,46
1132248,0,0,0,0,0,0,0,0
1132301,51,3,0,0,0,0,0,54
1132302,41,0,0,0,0,0,0,41
1132303,44,4,3,0,0,0,0,51
1132304,52,0,0,0,0,0,0,52
1132305,66,0,0,0,0,0,0,66
1132306,13,3,0,0,0,0,0,16
1132307,25,0,4,0,0,0,0,29
1132308,18,0,0,0,0,0,0,18
1132309,52,5,0,0,0,0,0,57
1132310,30,3,3,0,0,0,0,36
1132311,39,0,0,0,0,0,0,39
1132312,50,3,4,3,0,0,0,60
1132313,49,3,3,0,0,0,0,55
1132314,43,8,0,0,0,0,0,51
1132315,57,5,0,0,0,0,0,62
1132316,55,3,3,0,0,0,0,61
1132317,60,5,5,0,0,0,0,70
1132318,32,0,0,0,0,0,0,32
1132319,43,6,0,0,0,0,0,49
1132320,66,0,0,0,0,0,0,66
1132321,0,0,0,0,0,0,0,0
1132322,37,0,4,0,0,0,0,41
1132323,38,5,0,0,0,0,0,43
1132324,0,0,0,0,0,0,0,0
1132325,57,3,0,3,0,0,0,63
1132326,45,0,0,3,0,0,0,48
1132327,61,4,0,5,0,0,0,70
1132328,49,0,5,0,0,0,0,54
1132329,34,0,0,0,0,0,0,34
1132401,0,0,0,0,0,0,0,0
1132501,0,0,0,0,0,0,0,0
1132601,21,4,0,0,0,0,0,25
1132602,52,3,0,0,0,0,0,55
1132603,23,0,0,0,0,0,0,23
1132604,32,3,3,0,0,0,3,41
1132605,32,0,0,0,0,0,0,32
1132606,47,0,3,0,0,0,0,50
1132607,66,4,0,0,0,0,0,70
1132608,37,5,0,0,0,0,0,42
1132609,30,9,0,0,0,0,0,39
1132610,36,5,0,0,0,0,0,41
1132611,59,0,5,0,0,0,0,64
1132612,28,0,4,0,0,0,0,32
1132613,52,0,0,0,0,0,3,55
1132614,30,0,0,0,0,0,0,30
1132615,29,3,3,0,0,0,0,35
1132616,33,0,0,3,0,0,0,36
1132617,30,0,0,0,0,0,0,30
1132618,38,3,3,0,0,0,0,44
1132619,47,0,0,3,0,0,0,50
1132620,60,3,0,3,3,0,0,69
1132621,26,4,0,0,0,0,0,30
1132622,62,3,0,0,0,0,0,65
1132623,53,3,0,0,0,0,0,56
1132624,34,3,0,0,0,0,0,37
1132625,41,4,0,0,0,0,0,45
1132626,18,3,3,0,0,0,3,27
1132627,52,0,0,0,0,0,0,52
1132628,41,0,0,0,0,0,3,44
1132629,50,4,0,0,0,0,0,54
1132630,38,0,0,0,0,0,0,38
1132631,19,5,0,0,0,0,0,24
1132632,62,0,5,0,0,0,0,67
1132633,41,3,0,0,0,0,0,44
1132634,25,0,3,0,0,0,0,28
1132635,26,3,3,0,0,0,0,32
1132636,33,4,0,0,0,0,0,37
1132637,35,0,3,0,3,0,0,41
1132638,40,4,0,0,0,0,0,44
1132639,12,3,0,0,0,0,0,15
1132640,39,5,3,0,0,0,0,47
1132641,9,0,0,3,0,0,0,12
1132642,30,9,0,0,0,0,0,39
1132643,43,3,0,3,0,0,0,49
1132644,46,4,3,0,0,0,0,53
1132645,38,3,0,3,0,0,0,44
1132646,13,0,0,0,0,0,0,13
1132647,56,0,0,0,0,0,0,56
1132648,45,3,0,0,0,0,0,48
1132649,36,3,0,0,0,0,0,39
1132650,31,5,0,0,0,0,0,36
1132651,60,6,0,0,0,0,0,66
1132652,44,0,0,3,0,0,0,47
1132653,38,0,0,0,0,0,0,38
1132654,23,0,0,3,0,0,0,26
1132655,29,0,4,0,0,0,0,33
1132656,30,5,0,0,0,0,0,35
1132657,46,4,4,0,0,0,0,54
1132658,0,3,0,0,0,0,0,3
1132659,42,0,0,4,0,0,0,46
1132660,27,0,0,0,0,0,0,27
1132661,37,3,3,0,0,0,0,43
1132662,36,3,0,0,0,0,0,39
1132701,54,4,0,0,0,0,0,58
1132702,31,0,0,0,0,0,0,31
1132703,24,3,0,0,0,0,0,27
1132704,40,4,0,0,0,0,0,44
1132705,25,3,0,0,0,0,0,28
1132706,48,3,0,0,0,0,0,51
1132707,49,3,0,0,0,0,0,52
1132708,41,6,0,0,0,0,0,47
1132709,23,3,0,0,0,0,3,29
1132710,50,5,0,0,0,0,0,55
1132711,48,3,0,3,0,0,0,54
1132712,27,0,3,0,0,0,0,30
1132713,55,0,0,0,0,0,0,55
1132714,25,3,0,0,0,0,0,28
1132715,24,3,0,0,0,0,3,30
1132716,48,0,0,0,0,0,0,48
1132717,6,3,0,0,0,0,0,9
1132718,64,6,0,0,0,0,0,70
1132719,42,3,0,0,0,0,0,45
1132720,21,0,0,0,0,0,0,21
1132721,20,3,0,0,0,0,0,23
1132722,39,0,0,0,0,0,0,39
1132723,23,6,0,0,0,0,0,29
1132724,27,0,0,0,0,0,0,27
1132725,24,3,0,0,0,0,3,30
1132726,22,0,0,0,0,0,0,22
1132727,13,3,0,0,0,0,0,16
1132728,33,0,3,0,0,0,0,36
1132729,40,3,0,0,0,0,0,43
1132730,32,3,0,3,0,0,0,38
1132731,25,4,0,0,0,0,0,29
1132732,35,3,3,0,0,0,0,41
1132733,50,0,0,0,0,0,0,50
1132734,26,0,0,0,0,0,0,26
1132735,22,0,0,0,0,0,0,22
1132736,23,0,0,0,0,0,0,23
1132737,33,0,0,0,0,0,0,33
1132738,27,0,0,0,0,0,0,27
1132739,27,3,3,0,0,0,0,33
1132740,28,0,0,0,0,0,0,28
1132741,13,3,0,0,0,0,0,16
1132742,30,6,0,0,0,0,0,36
1132743,23,3,3,0,0,0,0,29
1132744,17,0,0,0,0,0,0,17
1132745,13,3,3,0,0,0,0,19
1132746,12,0,0,0,0,0,0,12
1132747,18,3,0,0,0,0,0,21
1132748,23,3,0,0,0,0,0,26
1132749,30,5,0,0,0,0,0,35
1132750,34,4,0,0,0,0,0,38
1132801,40,3,3,0,0,0,0,46
1132802,24,0,0,0,0,0,0,24
1132803,11,0,0,4,0,0,0,15
1132804,14,3,0,0,0,0,0,17
1132805,3,0,0,0,0,0,0,3
1132806,25,0,0,0,0,0,0,25
1132807,58,0,3,0,0,0,0,61
1132808,32,4,0,4,0,0,0,40
1132809,29,0,0,0,0,0,0,29
1132810,59,6,0,0,0,0,0,65
1132811,55,0,0,0,0,0,0,55
1132812,37,3,0,0,0,0,0,40
1132813,0,0,3,0,0,0,0,3
1132814,34,3,0,4,0,0,0,41
1132815,19,3,0,3,0,0,0,25
1132816,3,0,0,0,0,0,0,3
1132817,45,0,3,3,0,0,0,51
1132818,12,5,0,0,0,0,0,17
1132819,20,0,0,0,0,0,0,20
1132820,23,3,0,0,0,0,0,26
1132821,40,4,0,0,0,0,0,44
1132822,34,3,3,0,0,0,0,40
1132901,13,0,0,0,0,0,0,13
1132902,0,0,0,0,0,0,0,0
1132903,5,0,0,0,0,0,0,5
1132904,5,0,3,0,0,0,0,8
1132905,3,0,0,0,0,0,0,3
1132906,16,0,0,0,0,0,0,16
1132907,0,0,0,0,0,0,0,0
1132908,4,0,0,0,0,0,0,4
1132909,0,0,0,0,0,0,0,0
1132910,3,3,0,0,0,0,0,6
1132911,3,0,0,0,0,0,0,3
1132912,10,0,0,0,0,0,0,10
1132913,30,0,0,0,0,0,0,30
1132914,20,5,0,0,0,0,0,25
1132915,0,0,0,0,0,0,0,0
1132916,4,0,0,0,0,0,0,4
1132917,7,0,0,0,0,0,0,7
1132918,3,0,0,0,0,0,0,3
1132919,12,3,0,0,0,0,0,15
1132920,4,0,0,0,0,0,0,4
1132921,7,0,0,0,0,0,0,7
1132922,15,0,0,0,0,0,0,15
1132923,6,0,0,0,0,0,0,6
1132924,13,0,0,0,0,0,0,13
1132925,12,3,0,0,0,0,0,15
1132926,31,3,3,0,0,0,0,37
1132927,9,0,0,0,0,0,0,9
1132928,5,0,0,0,0,0,0,5
1133001,14,4,4,0,0,0,0,22
1133002,36,3,3,0,0,0,0,42
1133003,34,4,0,0,0,0,0,38
1133004,23,4,0,0,0,0,0,27
1133005,24,3,0,0,0,0,0,27
1133006,36,4,0,0,0,0,0,40
1133007,18,4,0,0,0,0,0,22
1133008,48,7,0,0,0,0,0,55
1133009,15,4,0,0,0,0,0,19
1133010,48,0,0,0,0,0,0,48
1133011,21,0,0,0,0,0,0,21
1133012,66,7,0,0,0,0,0,73
1133013,0,0,0,0,0,0,0,0
1133014,0,0,0,0,0,0,0,0
1133015,20,3,0,0,0,0,0,23
1133016,42,3,0,3,0,0,0,48
1133017,29,5,0,0,0,0,0,34
1133018,0,0,0,0,0,0,0,0
1133019,24,5,4,0,0,0,0,33
1133020,0,0,0,0,0,0,0,0
1133021,13,3,0,0,0,0,0,16
1133022,12,0,0,0,0,0,0,12
1133023,9,3,3,0,0,0,0,15
1133024,24,3,3,0,0,0,0,30
1133025,51,0,0,0,0,0,0,51
1133026,38,3,3,0,0,0,0,44
1133027,23,0,3,0,0,0,0,26
1133028,43,6,0,0,0,0,0,49
1133029,26,0,3,0,0,0,3,32
1133030,44,0,0,0,0,0,0,44
1133031,25,5,0,3,0,0,0,33
1133032,36,3,0,0,0,0,0,39
1133101,0,0,0,0,0,0,0,0
1133102,20,0,0,0,0,0,0,20
1133103,21,3,0,0,0,0,0,24
1133104,24,3,3,0,0,0,0,30
1133105,19,0,3,0,0,0,0,22
1133106,12,0,0,0,0,0,0,12
1133107,7,3,0,0,0,0,0,10
1133108,16,0,0,0,0,0,0,16
1133109,22,0,0,0,0,0,0,22
1133110,13,0,0,0,0,0,0,13
1133111,38,0,0,4,0,0,0,42
1133112,22,5,0,0,0,0,0,27
1133113,16,0,0,0,0,0,0,16
1133114,14,4,0,0,0,0,0,18
1133115,9,0,4,0,0,0,0,13
1133116,21,3,0,0,0,0,0,24
1133117,34,3,0,0,0,0,0,37
1133118,21,3,6,0,0,0,0,30
1133119,28,0,0,0,0,0,0,28
1133120,35,3,0,0,0,0,0,38
1133121,34,4,0,0,0,0,0,38
1133122,20,0,0,0,0,0,0,20
1133123,15,0,0,0,0,0,0,15
1133124,50,5,0,0,3,0,0,58
1133125,21,0,0,0,0,0,0,21
1133126,12,6,0,0,0,0,0,18
1133127,27,0,0,0,0,0,3,30
1133128,0,0,0,0,0,0,0,0
1133129,8,0,0,0,0,0,0,8
1133130,4,3,0,0,0,0,0,7
1133131,13,3,0,0,0,0,0,16
1133132,11,4,0,0,0,0,0,15
1133133,13,4,0,0,0,0,0,17
1133134,10,0,0,3,0,0,0,13
1133135,27,0,0,0,0,0,0,27
1133136,29,3,4,0,0,0,0,36
1133137,23,0,0,0,0,0,0,23
1133138,19,4,0,0,0,0,0,23
1133139,25,3,0,4,0,0,0,32
1133140,22,0,4,0,0,0,0,26
1133141,19,3,0,0,0,0,0,22
1133142,24,0,0,0,0,0,0,24
1133201,8,0,0,0,0,0,0,8
1133202,4,0,0,0,0,0,0,4
1133203,0,0,0,0,0,0,0,0
1133204,17,4,0,0,0,0,0,21
1133205,13,0,0,0,0,3,0,16
1133206,36,5,0,0,0,0,0,41
1133207,23,0,0,0,0,0,0,23
1133208,30,0,0,0,0,0,0,30
1133209,17,3,0,0,0,0,0,20
1133210,14,0,0,0,0,0,0,14
1133211,7,0,0,0,0,0,0,7
1133212,18,4,0,0,0,0,0,22
1133213,30,0,0,0,0,0,0,30
1133214,0,0,0,0,0,0,0,0
1133215,22,0,0,0,0,0,0,22
1133216,21,0,0,0,0,0,0,21
1133217,7,0,0,0,0,0,0,7
1133218,19,0,3,0,0,0,0,22
1133219,35,3,0,0,0,0,0,38
1133220,34,4,0,0,0,0,0,38
1133221,29,3,0,0,0,0,0,32
1133222,18,0,0,0,0,0,0,18
1133223,30,0,0,0,0,0,0,30
1133224,32,6,0,0,0,0,0,38
1133225,24,0,3,0,0,0,0,27
1133226,36,3,3,3,0,0,0,45
1133227,24,0,0,0,0,0,0,24
1133228,17,0,0,5,0,0,0,22
1133229,30,0,0,0,0,0,0,30
1133230,23,0,0,0,0,0,0,23
1133231,25,0,0,0,0,0,0,25
1133232,16,0,0,0,0,0,0,16
1133233,10,3,0,0,0,0,0,13
1133234,41,0,3,0,0,0,0,44
1133235,33,4,0,0,0,0,0,37
1133236,37,0,3,0,0,0,0,40
1133237,27,3,0,0,0,0,0,30
1133238,34,4,0,0,0,0,0,38
1133239,17,0,0,0,0,0,0,17
1133240,24,0,0,0,0,0,0,24
1133241,25,3,0,0,0,0,0,28
1133242,18,4,0,0,0,0,0,22
1133243,28,6,0,0,0,0,3,37
1133244,16,0,0,0,0,0,0,16
1133245,22,0,3,0,0,0,0,25
1133246,19,0,0,0,0,0,0,19
1133247,34,0,0,0,0,0,0,34
1133248,11,0,0,0,0,0,0,11
1133249,35,3,0,0,0,0,0,38
1133250,24,0,0,0,0,0,0,24
1133251,8,0,0,0,0,0,0,8
1133252,28,0,0,0,0,0,0,28
1133301,3,0,0,0,0,0,0,3
1133302,13,0,0,0,0,0,0,13
1133303,4,0,0,0,0,0,0,4
1133304,3,0,0,0,0,0,0,3
1133305,8,0,3,0,0,0,0,11
1133306,4,0,0,0,0,0,3,7
1133307,4,0,0,0,0,0,0,4
1133308,4,0,0,0,0,0,0,4
1133309,0,0,0,0,0,0,0,0
1133310,10,0,0,0,0,0,0,10
1133311,0,0,0,0,0,0,0,0
1133312,3,0,0,0,0,0,0,3
1133313,7,3,0,0,0,0,0,10
1133314,18,0,0,0,0,0,0,18
1133315,4,0,0,0,0,0,0,4
1133316,6,3,0,0,0,0,0,9
1133317,0,0,0,0,0,0,0,0
1133318,11,0,0,0,0,0,0,11
1133319,11,0,0,0,0,0,0,11
1133320,10,0,0,0,0,0,0,10
1133321,4,0,0,0,0,0,0,4
1133322,5,3,0,0,0,0,0,8
1133323,7,3,0,0,0,0,0,10
1133324,5,4,0,0,0,0,0,9
1133325,15,5,0,0,0,0,0,20
1133326,10,0,0,0,0,0,0,10
1133327,7,0,0,0,0,0,0,7
1133328,6,0,0,0,0,0,4,10
1133329,22,3,0,0,0,0,0,25
1133330,5,0,0,0,0,0,0,5
1133331,15,0,0,0,0,0,0,15
1133332,6,3,0,0,0,0,3,12
1133333,21,4,0,0,0,0,0,25
1133334,11,0,0,0,0,0,0,11
1133335,17,0,0,0,0,0,0,17
1133336,4,0,0,0,0,0,0,4
1133337,3,0,0,0,0,0,0,3
1133338,10,0,0,0,0,0,0,10
1133339,7,0,0,0,0,0,0,7
1133340,19,0,0,0,0,0,0,19
1133341,11,3,0,0,0,0,0,14
1133342,11,0,0,0,0,0,0,11
1133343,10,0,4,0,0,0,0,14
1133344,6,0,3,0,0,0,0,9
1133345,17,4,0,0,0,0,0,21
1133346,4,0,0,0,0,0,0,4
1133347,6,0,0,0,0,0,0,6
1133348,10,0,0,0,0,0,0,10
1133349,9,0,0,0,0,0,0,9
1133401,11,3,0,0,0,0,0,14
1133402,24,0,0,0,0,0,0,24
1133403,29,3,0,0,0,0,0,32
1133404,16,0,0,0,0,0,0,16
1133405,3,3,0,0,0,0,0,6
1133406,24,0,0,0,0,0,0,24
1133407,30,3,0,0,0,0,0,33
1133408,22,0,0,0,0,0,0,22
1133409,11,0,0,0,0,0,0,11
1133410,15,0,0,0,0,0,0,15
1133411,38,0,0,0,0,0,0,38
1133412,50,5,3,3,0,0,3,64
1133413,24,0,0,0,0,0,0,24
1133414,0,0,0,0,0,0,0,0
1133415,69,4,0,0,0,0,0,73
1133416,29,3,0,0,0,0,0,32
1133417,47,4,0,0,0,0,0,51
1133418,33,5,0,0,0,0,0,38
1133419,27,3,0,0,0,0,0,30
1133420,11,0,0,0,0,0,0,11
1133421,25,3,3,0,0,0,0,31
1133422,26,0,3,0,0,0,0,29
1133423,16,0,0,0,0,0,0,16
1133424,3,0,0,0,0,0,0,3
1133425,10,0,0,0,0,0,0,10
1133426,12,3,0,0,0,0,0,15
1133427,18,0,0,0,0,0,0,18
1133428,11,4,0,0,0,0,0,15
1133429,9,0,0,0,0,0,0,9
1133430,25,3,0,3,0,0,0,31
1133431,19,0,0,0,0,0,4,23
1133432,22,3,3,0,0,0,0,28
1133433,9,0,0,0,0,0,0,9
1133434,24,0,0,0,0,0,0,24
1133435,24,4,0,0,0,0,0,28
1133436,18,7,0,0,0,0,0,25
1133437,6,0,0,0,0,0,0,6
1133438,33,0,0,0,0,0,0,33
1133439,5,0,0,0,0,0,0,5
1133501,23,0,0,0,0,0,0,23
1133502,30,4,0,0,0,0,0,34
1133503,24,0,0,0,0,0,0,24
1133504,6,0,0,0,0,0,0,6
1133505,22,0,0,0,0,0,0,22
1133506,26,3,0,0,0,0,0,29
1133507,25,0,0,0,0,0,0,25
1133508,0,0,0,0,0,0,0,0
1133509,12,3,0,0,0,0,0,15
1133510,13,0,0,0,0,0,0,13
1133511,10,0,0,0,0,0,0,10
1133512,0,0,0,0,0,0,0,0
1133513,10,0,0,0,0,0,0,10
1133514,11,3,0,0,0,0,0,14
1133515,10,0,0,0,0,0,0,10
1133516,13,0,0,0,0,0,0,13
1133517,4,0,0,0,0,0,0,4
1133518,12,0,0,0,0,0,0,12
1133519,9,0,0,0,0,0,0,9
1133520,0,0,0,0,0,0,0,0
1133521,24,3,3,0,0,0,0,30
1133522,11,3,0,0,0,3,0,17
1133523,12,3,3,0,0,0,0,18
1133524,0,0,0,0,0,0,0,0
1133525,16,0,0,0,0,0,0,16
1133526,9,0,0,0,0,0,0,9
1133527,8,0,0,0,0,0,0,8
1133528,7,0,0,0,0,0,0,7
1133529,10,3,0,0,0,0,0,13
1133530,9,0,0,0,0,0,3,12
1133531,9,3,0,0,0,0,0,12
1133532,26,5,0,0,0,0,0,31
1133533,28,0,0,0,0,0,0,28
1133534,21,0,0,0,0,0,0,21
1133535,18,0,0,0,0,0,0,18
1133536,18,5,0,0,0,0,0,23
1133537,12,0,0,0,0,0,0,12
1133538,4,0,0,0,0,0,0,4
1133539,14,3,0,0,0,0,0,17
1133540,14,4,0,0,0,0,0,18
1133541,15,3,0,0,0,0,0,18
1133542,24,3,3,0,0,0,0,30
1133601,0,0,0,0,0,0,0,0
1133602,20,0,0,0,0,0,0,20
1133603,13,0,0,0,0,0,0,13
1133604,28,5,0,0,0,0,0,33
1133605,21,0,0,0,0,0,0,21
1133606,12,0,3,0,0,0,0,15
1133607,22,0,0,0,0,0,0,22
1133608,15,0,0,0,0,0,0,15
1133609,6,0,0,0,0,0,3,9
1133610,12,0,0,0,0,0,0,12
1133611,5,0,0,0,0,0,0,5
1133612,7,0,0,0,0,0,0,7
1133613,10,0,0,0,0,0,0,10
1133614,15,0,0,0,0,0,0,15
1133615,9,0,0,0,0,0,0,9
1133616,20,0,0,0,0,0,0,20
1133617,15,0,0,0,0,0,0,15
1133618,11,0,0,0,0,0,0,11
1133619,3,3,0,0,0,0,0,6
1133620,0,3,0,0,0,0,0,3
1133621,14,3,0,0,0,0,0,17
1133622,8,4,0,0,0,0,0,12
1133623,4,0,0,0,0,0,0,4
1133624,6,0,0,0,0,0,0,6
1133625,16,3,0,0,0,0,0,19
1133626,19,0,0,3,0,0,0,22
1133627,12,0,0,0,0,0,0,12
1133628,16,0,0,0,0,0,0,16
1133629,13,3,0,0,0,0,0,16
1133630,14,3,0,0,0,0,0,17
1133631,12,4,0,0,0,0,0,16
1133632,20,4,0,0,0,0,0,24
1133633,7,0,0,3,0,0,0,10
1133634,26,0,4,0,0,0,0,30
1133635,4,0,0,0,0,0,0,4
1133636,17,0,0,0,0,0,0,17
1133701,6,0,0,0,0,0,0,6
1133702,3,0,0,3,0,0,0,6
1133703,29,4,3,5,0,0,0,41
1133704,5,3,0,0,0,0,0,8
1133705,10,0,0,0,0,0,0,10
1133706,9,0,0,0,0,0,0,9
1133707,15,4,0,0,0,0,0,19
1133708,12,0,0,0,0,0,0,12
1133709,8,3,0,0,0,0,0,11
1133710,22,0,0,0,0,0,0,22
1133711,18,3,0,0,0,0,0,21
1133712,58,4,0,0,0,0,0,62
1133713,0,0,0,0,0,0,0,0
1133714,12,0,0,0,0,0,0,12
1133715,57,0,0,0,0,0,4,61
1133716,20,0,0,0,0,0,0,20
1133717,18,0,0,0,0,0,0,18
1133718,22,0,0,0,0,0,0,22
1133719,16,4,0,0,0,0,0,20
1133720,0,0,0,0,0,0,0,0
1133721,51,3,0,0,0,0,0,54
1133722,25,4,0,0,0,0,0,29
1133723,7,0,0,0,0,0,0,7
1133724,13,4,0,0,0,0,0,17
1133725,9,0,0,0,0,0,0,9
1133726,6,0,0,0,0,0,0,6
1133727,3,0,0,0,0,0,0,3
1133728,3,0,0,0,0,0,0,3
1133729,3,0,0,0,0,0,0,3
1133730,3,3,0,0,0,0,0,6
1133731,0,0,0,0,0,0,0,0
1133732,0,0,0,0,0,0,0,0
1133733,7,0,0,0,0,0,0,7
1133734,16,0,0,4,0,0,0,20
1133735,4,4,0,0,0,0,0,8
1133736,14,0,0,0,0,0,0,14
1133737,21,0,0,0,0,0,0,21
1133738,29,4,0,0,0,0,0,33
1133739,0,0,0,0,0,0,0,0
1133740,6,0,0,0,0,0,0,6
1133741,0,0,0,0,0,0,0,0
1133742,31,0,0,0,0,0,0,31
1133743,9,0,0,0,0,0,0,9
1133744,10,0,0,0,0,0,0,10
1133745,0,0,0,0,0,0,0,0
1133746,6,0,0,0,0,0,0,6
1133747,10,0,0,0,0,0,0,10
1133748,10,0,0,0,0,0,0,10
1133749,9,3,0,0,0,0,0,12
1133750,0,0,0,0,0,0,0,0
1133751,12,0,0,0,0,0,0,12
1133752,0,0,0,0,0,0,0,0
1133801,5,0,0,0,0,0,0,5
1133802,8,0,0,0,0,0,0,8
1133803,21,0,0,0,0,0,0,21
1133804,13,6,0,0,0,0,0,19
1133805,13,4,0,0,0,0,0,17
1133806,5,0,0,0,0,0,0,5
1133807,41,0,0,0,0,0,0,41
1133808,21,3,0,0,0,0,0,24
1133809,22,0,0,0,0,0,0,22
1133810,17,0,0,0,0,0,0,17
1133811,22,5,0,0,0,0,0,27
1133812,0,0,0,0,0,0,0,0
1133813,22,4,0,0,0,0,0,26
1133814,44,7,3,3,0,0,0,57
1133815,20,0,0,0,0,0,0,20
1133816,31,5,0,0,0,0,0,36
1133817,50,4,3,0,0,0,0,57
1133818,21,3,0,0,0,0,0,24
1133819,0,0,0,0,0,0,0,0
1133820,82,4,0,0,0,0,0,86
1133821,62,0,0,0,0,0,0,62
1133822,14,0,0,0,0,0,0,14
1133823,46,0,0,0,0,0,0,46
1133824,70,0,0,4,0,0,0,74
1133825,215,11,3,4,0,0,0,233
1133826,94,4,0,0,0,0,0,98
1133827,80,7,0,0,0,0,0,87
1133828,20,0,3,0,0,0,0,23
1133829,42,3,0,0,0,0,0,45
1133830,24,0,0,3,0,0,0,27
1133831,17,0,0,0,0,0,0,17
1133832,11,0,0,0,0,0,0,11
1133833,10,3,3,0,0,0,0,16
1133834,3,0,0,0,0,0,0,3
1133835,19,0,0,0,0,0,0,19
1133836,7,3,0,0,0,0,0,10
1133837,12,3,4,0,0,0,0,19
1133838,0,0,0,0,0,0,0,0
1133839,11,0,0,0,0,0,0,11
1133840,5,3,0,0,0,0,0,8
1133841,13,0,0,0,0,0,0,13
1133901,63,7,3,0,0,0,0,73
1133902,46,0,0,0,0,0,0,46
1133903,32,0,0,0,0,0,0,32
1133904,43,0,0,0,0,0,0,43
1133905,72,6,0,0,0,0,0,78
1133906,37,4,3,0,0,0,0,44
1133907,51,4,0,0,0,0,0,55
1133908,37,3,0,0,0,0,0,40
1133909,0,0,0,0,0,0,0,0
1133910,44,3,0,0,0,0,0,47
1133911,48,3,0,0,0,0,0,51
1133912,37,5,0,0,0,0,0,42
1133913,44,3,0,0,0,0,0,47
1133914,35,0,0,0,0,0,0,35
1133915,26,0,0,0,0,0,0,26
1133916,0,0,0,0,0,0,0,0
1133917,23,3,3,0,0,0,0,29
1133918,30,0,0,0,0,0,0,30
1133919,28,3,0,0,0,0,0,31
1133920,28,4,0,0,0,0,0,32
1133921,46,3,0,0,0,0,0,49
1133922,27,0,5,0,0,0,0,32
1133923,44,0,0,0,0,0,0,44
1133924,18,0,0,0,0,0,0,18
1133925,19,0,0,0,0,0,0,19
1133926,36,3,0,0,0,0,0,39
1133927,48,0,3,0,0,0,0,51
1133928,32,4,0,0,0,0,0,36
1133929,17,0,3,0,0,0,0,20
1133930,31,7,0,0,0,0,0,38
1133931,24,3,0,0,0,0,0,27
1133932,36,3,3,0,0,0,0,42
1133933,32,0,0,0,0,0,0,32
1133934,28,3,0,0,0,0,0,31
1133935,23,0,0,0,0,0,0,23
1133936,23,3,0,0,0,0,0,26
1133937,26,3,0,0,0,0,0,29
1133938,33,0,0,0,0,0,0,33
1133939,11,3,3,0,0,0,0,17
1133940,42,0,0,0,0,0,0,42
1133941,23,0,0,3,0,0,0,26
1133942,32,4,0,0,0,0,0,36
1133943,31,3,0,0,0,0,0,34
1133944,37,0,0,3,0,0,0,40
1133945,16,3,0,0,0,0,0,19
1133946,6,0,0,0,0,0,0,6
1133947,42,3,0,0,0,0,0,45
1134001,8,3,0,0,0,0,0,11
1134002,13,0,0,0,0,0,0,13
1134003,32,6,0,0,0,0,0,38
1134004,12,0,0,0,0,0,0,12
1134005,39,3,0,0,0,0,0,42
1134006,50,5,0,0,0,0,0,55
1134007,29,5,0,0,0,0,0,34
1134008,29,0,0,0,0,0,0,29
1134009,27,0,0,0,0,0,0,27
1134010,15,3,0,0,0,0,0,18
1134011,23,0,3,0,0,0,0,26
1134012,22,3,0,0,0,0,0,25
1134013,31,0,3,0,0,0,0,34
1134014,39,0,0,0,0,0,0,39
1134015,44,3,0,0,0,0,0,47
1134016,9,0,0,0,0,0,0,9
1134017,32,4,0,0,0,0,0,36
1134018,37,3,0,3,0,0,0,43
1134019,14,0,0,0,0,0,0,14
1134020,32,3,0,0,0,0,0,35
1134021,21,0,3,0,0,0,0,24
1134022,28,0,0,0,0,0,0,28
1134023,24,0,0,0,0,0,0,24
1134024,26,0,0,0,0,0,0,26
1134025,37,3,3,0,0,0,3,46
1134026,42,5,0,0,0,0,0,47
1134027,68,3,0,0,0,0,0,71
1134028,50,0,3,0,0,0,0,53
1134029,83,0,3,0,0,0,0,86
1134030,60,0,0,0,0,0,0,60
1134031,40,5,0,0,0,0,0,45
1134032,47,0,0,0,0,0,0,47
1134033,39,0,3,0,0,0,0,42
1134034,0,0,0,0,0,0,0,0
1134035,3,0,0,0,0,0,0,3
1134036,32,3,0,0,0,0,0,35
1134037,30,3,3,0,0,0,0,36
1134038,44,4,0,0,0,0,0,48
1134039,63,0,0,0,0,0,0,63
1134040,51,3,0,0,0,0,0,54
1134041,25,3,0,0,0,0,0,28
1134042,68,3,0,0,0,0,0,71
1134043,73,0,0,0,0,0,0,73
1134044,42,3,3,0,0,0,0,48
1134045,12,3,3,0,0,0,0,18
1134046,0,0,0,0,0,0,0,0
1134047,38,0,0,0,0,0,0,38
1134101,21,4,0,0,0,0,0,25
1134102,11,3,0,0,0,0,0,14
1134103,42,8,3,0,0,0,0,53
1134104,55,0,0,0,0,0,0,55
1134105,6,0,0,0,0,0,0,6
1134106,10,0,0,0,0,0,0,10
1134107,48,9,0,0,0,0,0,57
1134108,49,0,0,0,0,0,0,49
1134109,16,3,0,0,0,0,0,19
1134110,48,6,0,0,0,0,0,54
1134111,21,4,0,0,0,0,0,25
1134112,54,3,3,0,0,0,0,60
1134113,22,4,0,0,0,0,0,26
1134114,25,3,0,0,0,0,0,28
1134115,52,4,0,0,0,0,0,56
1134116,23,4,0,0,0,0,0,27
1134117,17,0,0,0,0,0,0,17
1134118,24,0,0,0,0,0,0,24
1134119,19,3,0,0,0,0,0,22
1134120,19,3,3,0,0,0,0,25
1134121,35,3,3,0,0,0,0,41
1134122,14,0,0,0,0,0,0,14
1134123,33,0,0,0,0,0,0,33
1134124,26,4,0,0,0,0,0,30
1134125,12,0,0,0,0,0,0,12
1134126,47,3,3,0,0,0,0,53
1134127,38,4,0,0,0,0,0,42
1134128,86,10,0,0,0,0,0,96
1134129,66,3,0,0,0,0,0,69
1134130,40,3,0,0,0,0,0,43
1134131,63,4,0,0,0,0,0,67
1134132,41,3,0,0,0,0,0,44
1134133,52,3,0,0,0,0,0,55
1134134,40,3,0,0,0,0,0,43
1134135,54,4,0,0,0,0,0,58
1134136,0,0,0,0,0,0,0,0
1134137,36,0,0,0,0,0,0,36
1134138,32,4,0,0,0,0,0,36
1134139,28,3,0,0,0,0,0,31
1134201,0,0,0,0,0,0,0,0
1134301,21,0,0,0,0,0,0,21
1134302,34,0,0,0,0,0,0,34
1134303,32,3,0,0,0,0,0,35
1134304,34,0,0,0,0,0,0,34
1134305,13,0,0,0,0,0,0,13
1134306,20,3,0,0,0,0,0,23
1134307,44,4,0,0,0,0,0,48
1134308,41,6,0,0,0,0,0,47
1134309,7,3,0,0,0,0,0,10
1134310,4,0,0,0,0,0,0,4
1134311,18,3,3,0,0,0,0,24
1134312,53,6,6,0,0,0,0,65
1134313,74,5,3,0,0,0,0,82
1134314,59,3,3,3,0,0,0,68
1134315,28,0,0,0,0,0,0,28
1134316,47,3,3,0,0,0,0,53
1134317,37,0,0,0,0,0,0,37
1134318,28,0,0,0,0,0,0,28
1134319,31,0,0,0,0,0,0,31
1134320,28,0,0,0,0,0,0,28
1134321,28,3,3,0,0,0,0,34
1134322,25,3,0,0,0,0,3,31
1134323,24,4,0,0,0,0,0,28
1134324,35,3,0,0,0,0,0,38
1134325,17,0,0,0,0,0,0,17
1134326,9,0,0,0,0,0,0,9
1134327,32,3,0,0,0,0,0,35
1134328,28,3,0,0,0,0,0,31
1134329,13,0,0,0,0,0,0,13
1134330,22,0,0,0,0,0,0,22
1134331,25,3,0,0,0,0,0,28
1134332,60,6,0,0,0,0,0,66
1134333,67,0,3,0,0,0,0,70
1134334,21,0,0,0,0,0,0,21
1134335,36,0,0,0,0,0,0,36
1134336,32,3,0,0,0,0,0,35
1134337,15,4,0,0,0,0,0,19
1134338,28,6,0,0,0,0,0,34
1134339,40,4,0,0,0,0,0,44
1134340,46,3,0,0,0,0,0,49
1134341,34,3,0,0,0,0,0,37
1134342,38,3,0,0,0,0,0,41
1134343,16,4,0,0,0,0,0,20
1134344,31,0,3,0,0,0,0,34
1134345,55,3,3,0,0,0,0,61
1134346,69,0,0,0,0,0,0,69
1134347,32,6,0,0,0,0,0,38
1134348,29,6,0,0,0,0,0,35
1134349,38,0,0,0,0,0,0,38
1134350,56,3,0,0,0,0,0,59
1134351,47,6,0,0,0,0,0,53
1134352,29,0,0,0,0,0,0,29
1134353,59,4,3,0,0,0,0,66
1134354,26,3,0,0,0,0,0,29
1134355,34,0,0,0,0,0,0,34
1134356,38,3,0,0,0,0,0,41
1134357,27,0,0,0,0,0,0,27
1134401,69,5,0,4,0,0,0,78
1134402,57,4,0,0,0,0,0,61
1134403,55,3,3,0,0,0,0,61
1134404,37,4,0,0,0,0,0,41
1134405,45,0,0,0,0,0,0,45
1134406,49,0,0,0,0,0,0,49
1134407,49,4,0,0,0,0,3,56
1134408,50,0,0,0,0,0,0,50
1134409,46,0,4,0,0,0,0,50
1134410,39,0,0,0,0,0,0,39
1134411,46,4,0,0,0,0,0,50
1134412,56,4,3,0,0,0,0,63
1134413,35,3,0,0,0,0,0,38
1134414,49,0,5,0,0,0,0,54
1134415,41,3,0,0,0,0,0,44
1134416,63,3,0,0,0,0,0,66
1134417,39,3,3,0,0,0,0,45
1134418,66,3,0,0,0,0,0,69
1134419,44,3,0,0,0,0,0,47
1134420,39,3,3,0,0,0,0,45
1134421,60,5,0,0,0,0,0,65
1134422,75,0,0,0,0,0,0,75
1134423,50,0,0,0,0,0,0,50
1134424,105,3,3,0,0,0,0,111
1134501,21,5,0,3,0,0,0,29
1134502,40,0,0,0,0,0,0,40
1134503,27,0,0,0,0,0,0,27
1134504,24,6,0,0,0,0,0,30
1134505,41,5,0,0,0,0,0,46
1134506,13,0,0,0,0,0,0,13
1134507,32,0,5,0,0,0,0,37
1134508,41,3,3,0,0,0,3,50
1134509,29,0,0,0,0,0,0,29
1134510,22,6,0,0,0,0,0,28
1134511,33,0,0,0,0,0,0,33
1134512,54,3,0,0,0,0,0,57
1134513,24,0,0,0,0,0,0,24
1134514,0,0,0,0,0,0,0,0
1134515,0,0,0,0,0,0,0,0
1134516,30,3,0,0,0,0,0,33
1134517,22,0,4,0,0,0,0,26
1134518,18,5,0,0,0,0,0,23
1134519,32,0,4,0,0,0,0,36
1134520,23,0,0,0,0,0,0,23
1134521,37,0,3,0,0,0,0,40
1134522,0,0,0,0,0,0,0,0
1134523,24,0,0,0,0,0,0,24
1134524,21,3,0,0,0,0,0,24
1134525,15,0,0,0,0,0,0,15
1134526,19,0,3,0,0,0,0,22
1134527,23,3,0,0,0,0,0,26
1134528,36,3,0,0,0,0,0,39
1134529,52,5,0,0,0,0,0,57
1134530,47,3,0,0,0,0,0,50
1134531,38,0,0,0,0,0,0,38
1134532,24,3,0,0,0,0,0,27
1134533,31,0,0,0,0,0,0,31
1134534,19,3,0,0,0,0,0,22
1134535,36,3,3,0,0,0,0,42
1134536,20,0,0,0,0,0,0,20
1134537,13,0,0,0,0,0,0,13
1134601,20,3,0,0,0,0,0,23
1134602,27,3,0,0,0,0,0,30
1134603,57,4,0,0,0,0,0,61
1134604,56,0,0,0,0,0,0,56
1134605,39,4,0,0,0,0,0,43
1134606,97,0,4,0,0,0,0,101
1134607,0,0,0,0,0,0,0,0
1134608,54,3,3,0,0,0,0,60
1134609,67,0,0,0,0,0,0,67
1134610,21,3,0,0,0,0,0,24
1134611,0,0,0,0,0,0,0,0
1134612,68,3,3,0,0,0,0,74
1134613,64,0,3,3,0,0,0,70
1134614,34,0,0,0,0,0,0,34
1134615,33,3,3,0,0,0,0,39
1134616,43,4,0,0,0,0,0,47
1134617,72,3,0,0,0,0,0,75
1134618,66,4,0,0,0,0,3,73
1134619,0,0,0,0,0,0,0,0
1134620,66,3,3,0,0,0,0,72
1134621,47,3,3,0,0,0,0,53
1134622,42,0,0,0,0,0,0,42
1134623,44,6,0,0,0,0,0,50
1134624,50,6,0,0,0,0,0,56
1134625,58,5,0,0,0,0,0,63
1134626,62,3,0,0,0,0,0,65
1134627,52,4,0,0,0,0,0,56
1134628,88,3,0,0,0,0,0,91
1134629,4,0,0,0,0,0,0,4
1134630,70,3,0,0,0,0,0,73
1134631,36,3,3,0,0,0,0,42
1134632,44,3,0,0,0,0,0,47
1134701,45,0,0,0,0,0,0,45
1134702,45,0,0,0,0,0,0,45
1134703,14,0,0,0,0,0,0,14
1134704,41,3,3,0,0,0,0,47
1134705,95,0,0,0,0,0,0,95
1134706,28,3,0,0,0,0,0,31
1134707,38,3,3,0,0,0,0,44
1134708,45,3,0,0,0,0,0,48
1134709,25,0,0,0,0,0,0,25
1134710,45,3,0,0,0,0,0,48
1134711,30,3,3,0,0,0,0,36
1134712,23,4,0,0,0,0,0,27
1134713,38,3,0,0,0,0,0,41
1134714,45,3,0,0,0,0,0,48
1134715,23,3,0,0,0,0,0,26
1134716,28,0,0,0,0,0,0,28
1134717,18,4,0,0,0,0,0,22
1134801,82,0,3,0,0,0,0,85
1134802,61,3,0,3,0,0,0,67
1134803,78,3,0,0,0,0,0,81
1134804,36,4,0,0,0,0,0,40
1134805,28,3,0,0,0,0,0,31
1134806,22,3,0,0,0,0,0,25
1134807,34,3,0,0,0,0,0,37
1134808,15,0,0,0,0,0,0,15
1134809,38,3,0,0,0,0,0,41
1134810,25,0,0,0,0,0,0,25
1134811,44,3,0,0,0,0,0,47
1134812,44,3,0,0,0,0,0,47
1134813,36,0,0,0,0,0,0,36
1134814,84,0,0,3,0,0,0,87
1134815,37,3,0,0,0,0,0,40
1134816,74,0,0,0,0,0,0,74
1134817,63,4,3,0,0,0,0,70
1134818,49,3,0,0,0,0,0,52
1134819,33,5,0,0,0,0,0,38
1134820,16,4,0,0,0,0,0,20
1134821,38,0,3,0,0,0,0,41
1134822,38,0,0,0,0,0,0,38
1134823,27,0,0,0,0,0,0,27
1134824,38,3,0,0,0,0,0,41
1134825,24,4,0,0,0,0,0,28
1134826,45,3,0,0,0,0,3,51
1134827,9,0,0,0,0,0,0,9
1134828,51,0,0,0,0,0,0,51
1134829,48,0,3,0,0,0,0,51
1134830,35,0,0,0,0,0,0,35
1134831,30,0,0,0,0,0,0,30
1134832,33,0,0,0,0,0,0,33
1134833,20,3,3,0,0,0,0,26
1134834,25,0,0,0,0,0,0,25
1134835,43,3,0,0,0,0,0,46
1134836,24,3,0,0,0,0,0,27
1134837,46,3,0,0,0,0,0,49
1134838,30,4,0,0,0,0,0,34
1134839,28,3,0,0,0,0,0,31
1134840,36,0,0,0,0,0,0,36
1134841,25,3,0,0,0,0,0,28
1134842,38,0,0,0,0,0,0,38
1134843,44,0,0,0,0,0,0,44
1134844,21,0,0,0,0,0,0,21
1134845,33,0,0,0,0,0,0,33
1134846,34,0,3,0,0,0,0,37
1134847,52,4,0,0,0,0,0,56
1134848,45,0,0,0,0,0,0,45
1134849,38,3,3,0,0,0,0,44
1134850,52,0,0,0,0,0,0,52
1134851,48,0,0,3,0,0,0,51
1134852,43,3,0,0,0,0,0,46
1134853,22,3,0,3,0,0,0,28
1134854,49,3,0,0,0,0,0,52
1134855,17,0,0,0,0,0,0,17
1134856,35,4,0,0,0,0,0,39
1134857,33,5,0,0,0,0,0,38
1134858,26,0,0,0,0,0,0,26
1134859,13,0,0,0,0,0,0,13
1134860,27,0,0,0,0,0,0,27
1134901,24,0,0,0,0,0,0,24
1134902,49,0,0,3,0,0,3,55
1134903,32,0,0,0,0,0,0,32
1134904,43,0,0,0,0,0,0,43
1134905,17,0,0,0,0,0,0,17
1134906,13,0,0,0,0,0,0,13
1134907,29,4,0,0,0,0,0,33
1134908,30,3,0,0,0,0,0,33
1134909,75,0,4,0,0,0,0,79
1134910,44,3,0,0,0,0,0,47
1134911,0,0,0,0,0,0,0,0
1134912,58,0,0,0,0,0,0,58
1134913,26,0,0,0,0,0,0,26
1134914,18,0,0,0,0,0,0,18
1134915,56,3,0,0,0,0,0,59
1134916,48,6,0,0,0,0,3,57
1134917,52,0,0,0,0,0,0,52
1134918,56,0,0,0,0,0,0,56
1134919,32,3,0,3,0,0,0,38
1134920,65,5,0,0,0,0,0,70
1134921,33,5,0,0,0,0,0,38
1134922,37,0,4,0,0,0,0,41
1134923,49,4,0,0,0,0,0,53
1134924,72,0,0,0,0,0,0,72
1134925,23,0,0,0,0,0,0,23
1134926,27,0,0,0,0,0,0,27
1134927,33,4,0,0,0,0,0,37
1134928,17,0,0,0,0,0,0,17
1134929,36,0,3,0,0,0,0,39
1134930,45,0,0,0,0,0,0,45
1134931,54,4,6,0,0,0,0,64
1134932,72,5,3,0,0,0,0,80
1134933,72,0,0,0,0,0,0,72
1134934,49,6,3,0,0,0,0,58
1134935,21,3,3,0,0,0,0,27
1134936,51,3,0,3,0,0,0,57
1134937,25,5,0,0,0,0,0,30
1134938,41,0,0,0,0,0,0,41
1134939,23,0,0,0,0,0,0,23
1134940,7,0,0,0,0,0,0,7
1134941,34,0,0,0,0,0,0,34
1134942,46,0,0,0,0,0,0,46
1134943,15,0,0,0,0,0,0,15
1134944,57,5,4,0,0,0,0,66
1134945,36,0,0,0,0,0,0,36
1134946,31,6,3,0,0,0,0,40
1134947,52,3,0,0,0,0,0,55
1134948,45,0,0,0,0,0,3,48
1134949,33,0,0,0,0,0,0,33
1134950,38,0,0,3,0,0,0,41
1134951,34,3,3,3,0,0,0,43
1134952,35,0,0,0,0,0,0,35
1134953,10,0,0,0,0,0,0,10
1134954,23,0,0,0,0,0,0,23
1134955,32,0,0,0,0,0,0,32
1134956,22,0,3,0,0,0,0,25
1134957,24,3,0,0,0,0,0,27
1134958,7,0,0,0,0,0,0,7
1134959,32,3,0,0,0,0,0,35
1135001,33,6,5,0,0,0,0,44
1135002,62,3,0,3,0,0,0,68
1135003,72,3,4,4,0,0,0,83
1135004,48,0,0,0,0,0,0,48
1135005,92,3,4,0,0,0,0,99
1135006,69,0,0,3,0,0,0,72
1135007,4,0,3,0,0,0,0,7
1135008,55,0,3,0,0,3,3,64
1135009,65,0,3,0,0,0,0,68
1135010,33,3,3,0,0,0,0,39
1135011,61,0,3,0,0,0,0,64
1135012,45,3,3,0,0,0,3,54
1135013,16,3,0,0,0,0,0,19
1135014,30,0,0,0,0,0,3,33
1135015,58,8,0,0,0,0,0,66
1135016,127,10,0,0,0,0,0,137
1135017,33,4,0,0,0,0,0,37
1135018,67,5,4,0,0,0,3,79
1135019,25,3,5,0,0,0,0,33
1135020,58,3,0,0,0,0,0,61
1135021,71,7,5,0,0,0,0,83
1135022,49,6,0,0,0,0,0,55
1135023,74,0,0,0,0,0,0,74
1135024,0,0,0,0,0,0,0,0
1135025,0,0,0,0,0,0,0,0
1135026,0,0,0,0,0,0,0,0
1135027,41,3,0,0,0,0,0,44
1135028,0,0,0,0,0,0,0,0
1135029,68,3,0,0,0,0,0,71
1135030,43,0,5,0,0,0,0,48
1135031,0,3,0,0,0,0,0,3
1135032,34,4,0,3,0,0,0,41
1135033,44,0,0,0,0,0,0,44
1135034,39,0,4,3,0,0,0,46
1135035,42,6,0,0,0,0,0,48
1135036,44,5,0,0,0,0,0,49
1135037,70,0,3,0,0,0,0,73
1135038,79,3,3,0,0,0,0,85
1135039,78,3,6,0,0,0,0,87
1135040,61,3,3,0,0,0,0,67
1135041,61,4,0,0,0,0,0,65
1135042,45,6,3,0,0,0,0,54
1135043,41,3,3,0,0,0,0,47
1135044,73,5,0,0,0,0,3,81
1135045,71,10,3,3,0,0,0,87
1135046,78,6,0,0,0,0,0,84
1135047,48,3,0,0,0,0,0,51
1135048,66,4,4,4,0,0,0,78
1135101,3,0,0,0,0,0,3,6
1135102,16,0,0,0,0,0,3,19
1135103,60,3,0,3,0,0,0,66
1135104,33,3,3,0,0,0,0,39
1135105,44,3,0,0,0,0,0,47
1135106,30,3,0,0,0,0,0,33
1135107,58,5,3,0,0,0,0,66
1135108,40,3,3,0,0,0,0,46
1135109,0,0,0,0,0,0,0,0
1135110,22,3,0,0,0,0,0,25
1135111,59,0,3,0,0,0,0,62
1135112,49,0,0,3,0,0,0,52
1135113,51,4,0,0,0,0,0,55
1135114,22,0,4,0,0,0,0,26
1135115,68,4,0,0,0,0,0,72
1135116,68,0,5,0,0,0,0,73
1135117,79,0,0,0,0,0,0,79
1135118,50,0,0,0,0,0,0,50
1135119,51,3,0,0,0,0,0,54
1135120,60,5,0,0,0,0,0,65
1135121,35,0,4,0,0,0,0,39
1135122,28,0,3,0,0,0,0,31
1135123,57,3,0,0,0,0,0,60
1135124,63,3,3,0,0,0,3,72
1135125,32,3,0,0,0,0,0,35
1135126,40,3,0,0,0,0,0,43
1135127,71,5,0,0,0,0,0,76
1135128,52,3,0,3,0,0,0,58
1135129,42,3,0,0,0,0,0,45
1135130,31,3,0,3,0,0,0,37
1135131,63,0,0,0,0,0,0,63
1135132,46,0,0,0,0,0,0,46
1135133,28,4,5,0,0,0,0,37
1135134,48,5,0,0,0,0,0,53
1135135,63,3,3,3,0,0,0,72
1135136,57,3,0,0,0,0,0,60
1135137,62,3,3,0,0,0,0,68
1135138,67,3,0,0,0,0,0,70
1135139,60,3,0,0,0,0,0,63
1135140,74,0,0,0,0,0,0,74
1135141,36,0,0,3,0,0,0,39
1135142,57,0,0,0,0,0,0,57
1135143,24,3,0,4,0,0,0,31
1135144,64,3,0,0,0,0,0,67
1135145,50,0,3,0,0,0,0,53
1135146,42,4,0,0,0,0,0,46
1135147,24,3,0,0,0,0,0,27
1135148,62,0,0,0,0,0,0,62
1135149,72,6,0,0,0,0,0,78
1135150,28,4,3,0,0,0,0,35
1135151,29,0,0,0,0,3,0,32
1135152,58,3,3,0,0,0,3,67
1135153,6,3,0,0,0,0,0,9
1135154,36,4,0,0,0,0,0,40
1135155,39,3,0,0,0,0,3,45
1135156,61,3,0,0,0,0,0,64
1135157,28,3,0,0,0,0,0,31
1135158,44,4,3,3,0,0,0,54
1135159,55,3,0,0,0,0,0,58
1135160,50,4,0,0,0,0,0,54
1135161,44,6,0,0,0,0,0,50
1135162,25,3,0,0,0,0,0,28
1135163,58,6,0,0,0,0,0,64
1135164,42,3,3,0,0,0,0,48
1135165,29,3,0,0,0,0,0,32
1135166,44,0,3,0,0,0,0,47
1135167,48,4,0,0,0,0,0,52
1135201,0,0,0,0,0,0,0,0
1135202,29,0,0,0,0,0,0,29
1135203,62,3,3,0,0,0,0,68
1135204,32,3,0,0,0,0,0,35
1135205,38,0,3,0,0,0,0,41
1135206,18,3,0,0,0,0,0,21
1135207,52,3,0,0,0,0,0,55
1135208,6,0,0,0,0,0,0,6
1135209,25,0,0,0,0,0,0,25
1135210,21,3,0,0,0,0,0,24
1135211,51,0,0,0,0,0,0,51
1135212,12,3,0,3,0,0,0,18
1135213,62,3,0,0,0,0,0,65
1135214,29,0,0,0,0,0,0,29
1135215,54,3,0,0,0,0,0,57
1135216,31,0,0,0,0,0,0,31
1135217,47,5,4,0,0,0,0,56
1135218,55,0,0,0,0,0,0,55
1135219,50,0,0,0,0,0,0,50
1135220,37,3,0,3,0,0,0,43
1135221,39,0,0,0,0,0,0,39
1135222,36,0,3,0,0,0,0,39
1135223,30,0,0,0,0,0,0,30
1135224,11,0,0,0,0,0,0,11
1135225,33,3,0,0,0,0,0,36
1135226,32,4,0,0,0,0,0,36
1135227,22,4,0,0,0,0,0,26
1135228,17,3,0,0,0,0,0,20
1135229,37,4,0,0,0,0,0,41
1135230,49,5,0,0,0,0,0,54
1135231,30,3,0,3,0,0,0,36
1135232,27,0,0,0,0,0,0,27
1135233,16,0,0,0,0,0,0,16
1135234,58,4,0,0,0,0,0,62
1135235,39,7,0,0,0,0,0,46
1135236,29,0,3,3,0,0,0,35
1135237,28,3,0,0,0,0,0,31
1135238,39,3,0,0,0,0,0,42
1135239,35,0,0,0,0,0,0,35
1135240,33,4,0,0,0,0,0,37
1135241,36,6,0,0,0,0,0,42
1135242,24,4,0,0,0,0,0,28
1135243,21,0,4,0,0,0,0,25
1135244,31,0,0,0,0,0,0,31
1135245,36,5,0,0,0,0,0,41
1135246,26,0,3,0,0,0,0,29
1135247,68,3,0,3,0,0,0,74
1135248,49,3,3,0,0,0,0,55
1135249,68,4,0,0,0,0,0,72
1135250,52,0,0,0,0,0,0,52
1135251,34,0,0,0,0,0,0,34
1135252,34,0,3,0,0,0,0,37
1135253,39,0,0,0,0,0,0,39
1135254,37,6,0,0,0,0,0,43
1135255,39,3,0,0,0,0,0,42
1135256,45,3,0,0,0,0,0,48
1135257,45,5,0,0,0,0,0,50
1135258,39,4,3,0,0,0,0,46
1135259,68,3,5,0,0,0,0,76
1135260,49,3,0,0,0,0,0,52
1135261,62,0,0,0,0,0,0,62
1135262,39,5,0,0,0,0,0,44
1135263,47,3,4,0,0,0,0,54
1135264,66,0,0,0,0,0,0,66
1135265,23,0,0,0,0,0,0,23
1135266,24,3,0,0,0,0,0,27
1135267,55,5,0,0,0,0,0,60
1135268,18,3,0,0,0,0,0,21
1135301,37,4,5,0,0,0,0,46
1135302,0,0,0,0,0,0,0,0
1135303,67,3,0,3,0,0,3,76
1135304,103,4,0,0,0,0,0,107
1135305,43,3,0,3,0,0,0,49
1135306,0,0,0,0,0,0,0,0
1135307,36,3,4,0,0,0,0,43
1135308,0,0,0,0,0,0,0,0
1135309,35,0,0,0,0,0,0,35
1135310,145,16,3,3,0,0,0,167
1135311,78,4,3,0,0,0,0,85
1135312,48,0,0,4,0,0,0,52
1135313,45,4,0,3,0,0,0,52
1135314,38,0,0,0,0,0,3,41
1135315,49,3,0,3,0,0,0,55
1135316,50,3,3,5,0,0,0,61
1135317,63,3,8,0,0,0,0,74
1135318,56,4,0,0,0,0,0,60
1135319,61,0,0,4,0,0,0,65
1135320,70,4,0,4,0,0,0,78
1135321,52,4,0,3,0,0,0,59
1135322,50,0,3,0,0,0,0,53
1135323,51,0,0,3,0,0,0,54
1135324,59,6,3,3,0,0,0,71
1135325,53,0,4,0,0,0,0,57
1135326,74,3,0,4,0,0,0,81
1135327,46,5,0,5,0,0,0,56
1135328,71,0,4,4,0,0,0,79
1135329,40,4,0,4,0,0,0,48
1135330,51,7,3,0,0,0,0,61
1135331,55,0,0,0,0,3,0,58
1135332,69,3,3,0,0,0,0,75
1135333,60,3,3,0,0,0,0,66
1135334,36,4,3,0,0,0,0,43
1135335,42,0,0,0,0,0,0,42
1135336,89,3,3,0,0,0,0,95
1135337,52,3,3,3,0,0,0,61
1135338,41,5,3,3,0,0,3,55
1135339,103,0,0,5,0,0,0,108
1135340,26,7,0,0,0,0,0,33
1135341,0,0,0,0,0,0,0,0
1135342,59,3,3,3,3,0,0,71
1135343,25,3,4,0,0,0,0,32
1135344,0,0,0,0,0,0,0,0
1135345,0,0,0,0,0,0,0,0
1135346,0,0,0,0,0,0,0,0
1135347,30,4,0,0,0,0,0,34
1135348,41,6,0,5,0,0,0,52
1135349,57,3,3,4,0,0,0,67
1135350,68,5,0,3,0,0,0,76
1135351,74,3,4,0,0,0,0,81
1135352,61,4,0,0,0,0,0,65
1135353,67,4,0,0,0,0,0,71
1135354,65,7,0,0,0,0,0,72
1135355,66,6,0,0,0,0,0,72
1135356,79,9,0,0,0,0,0,88
1135357,86,4,3,3,0,0,0,96
1135358,24,3,0,0,0,0,0,27
1135359,0,0,0,0,0,0,0,0
1135360,0,0,0,0,0,0,0,0
1135361,36,3,0,0,0,0,0,39
1135362,35,0,0,0,0,0,0,35
1135363,49,4,3,0,0,0,0,56
1135364,65,5,0,0,0,0,0,70
1135365,68,0,0,0,0,0,0,68
1135366,57,6,0,0,0,0,4,67
1135367,41,4,0,0,0,0,0,45
1135368,44,5,0,3,0,0,0,52
1135369,0,0,0,0,0,0,0,0
1135370,74,3,3,4,0,0,0,84
1135371,75,3,4,5,0,0,0,87
1135372,54,3,0,0,0,0,0,57
1135401,67,0,0,3,0,0,0,70
1135402,50,0,0,0,0,0,0,50
1135403,72,4,3,0,0,0,0,79
1135404,49,0,0,0,0,0,0,49
1135405,43,4,0,0,0,0,0,47
1135406,65,0,4,0,0,0,0,69
1135407,31,3,0,0,0,0,0,34
1135408,35,3,0,0,0,0,0,38
1135409,48,0,0,3,0,0,0,51
1135410,53,3,3,0,0,0,0,59
1135411,42,0,0,0,0,0,0,42
1135412,36,8,0,3,0,0,0,47
1135413,83,0,3,0,0,0,0,86
1135414,68,0,0,0,0,0,0,68
1135415,83,3,3,0,0,0,0,89
1135416,0,0,0,0,0,0,0,0
1135417,52,5,0,0,0,0,0,57
1135418,62,0,3,0,0,0,0,65
1135419,72,3,0,0,0,0,0,75
1135420,55,3,0,0,0,0,0,58
1135421,62,0,0,0,0,0,0,62
1135422,54,3,3,3,0,0,0,63
1135423,0,0,0,0,0,0,0,0
1135424,61,0,3,0,0,0,0,64
1135425,34,0,3,0,0,0,0,37
1135426,32,0,0,0,0,0,0,32
1135427,82,0,3,3,3,0,0,91
1135428,55,0,0,0,0,0,0,55
1135429,36,3,0,0,0,0,0,39
1135430,21,0,0,0,0,0,0,21
1135431,48,0,4,0,0,0,0,52
1135432,35,0,3,0,0,0,0,38
1135433,49,0,0,0,0,0,0,49
1135434,44,0,4,0,0,0,0,48
1135435,76,0,0,0,0,0,0,76
1135436,45,3,3,0,0,0,0,51
1135437,0,0,0,0,0,0,0,0
1135438,35,0,0,0,0,0,0,35
1135439,67,0,5,0,0,0,0,72
1135440,50,0,0,3,0,0,0,53
1135441,45,0,3,3,0,0,0,51
1135442,39,0,0,0,0,0,0,39
1135443,44,4,0,0,0,0,0,48
1135444,52,3,0,3,0,0,0,58
1135445,33,4,0,0,0,0,0,37
1135446,22,3,0,3,0,0,0,28
1135447,29,3,4,0,0,0,0,36
1135448,46,3,0,0,0,0,0,49
1135449,21,3,0,0,0,0,0,24
1135450,64,4,0,0,0,0,0,68
1135451,47,0,3,0,0,0,0,50
1135452,36,0,0,0,0,0,3,39
1135453,27,0,4,0,0,0,0,31
1135454,19,0,0,0,0,0,0,19
1135501,0,0,0,0,0,0,0,0
1135502,0,0,0,0,0,0,0,0
1135601,0,0,0,0,0,0,0,0
1135602,0,0,0,0,0,0,0,0
1135603,51,0,3,0,0,0,0,54
1135604,0,0,0,0,0,0,0,0
1135605,0,0,0,0,0,0,0,0
1135606,72,0,0,0,0,0,0,72
1135607,44,0,0,0,0,0,0,44
1135608,57,0,5,0,0,5,0,67
1135609,59,0,3,3,0,0,0,65
1135610,73,3,3,5,0,0,0,84
1135611,74,6,3,3,0,0,0,86
1135612,65,5,0,0,0,0,0,70
1135613,79,3,0,4,0,0,0,86
1135614,56,3,3,0,0,0,0,62
1135615,68,3,3,0,0,3,0,77
1135616,38,3,0,0,0,0,0,41
1135617,42,0,3,0,0,0,0,45
1135618,75,3,0,3,0,0,3,84
1135619,69,0,3,3,0,0,3,78
1135620,0,0,0,0,0,0,0,0
1135621,57,0,3,0,0,0,0,60
1135622,0,0,0,0,0,0,0,0
1135623,65,4,4,0,0,0,0,73
1135624,67,0,0,0,0,0,0,67
1135625,45,0,4,0,0,0,0,49
1135626,38,0,0,0,0,0,0,38
1135627,52,4,0,0,0,0,0,56
1135628,41,3,0,0,0,0,3,47
1135629,34,3,0,0,0,0,0,37
1135701,61,3,3,0,0,0,0,67
1135702,50,0,4,0,0,0,0,54
1135703,45,0,0,0,0,0,0,45
1135704,50,3,3,0,0,0,0,56
1135705,36,4,0,0,0,0,0,40
1135706,97,3,3,0,0,0,0,103
1135707,48,3,4,0,0,0,0,55
1135708,82,3,3,0,0,0,0,88
1135709,61,0,0,0,0,0,0,61
1135710,50,0,0,0,0,0,0,50
1135711,75,3,5,3,0,0,0,86
1135712,85,5,4,3,0,0,0,97
1135713,73,3,0,0,0,0,0,76
1135714,32,3,3,0,0,0,0,38
1135715,44,3,3,0,0,0,0,50
1135716,84,3,0,3,0,3,0,93
1135717,41,4,0,0,0,0,0,45
1135718,56,0,0,3,0,0,3,62
1135719,33,0,0,0,0,0,0,33
1135720,45,0,0,0,0,0,0,45
1135721,61,4,5,0,0,0,0,70
1135722,56,0,0,0,0,0,0,56
1135723,58,0,0,0,0,0,3,61
1135724,55,0,0,0,0,0,0,55
1135725,53,4,3,0,0,0,0,60
1135726,79,4,0,0,0,0,0,83
1135727,67,3,0,0,0,0,0,70
1135728,71,4,0,4,0,0,0,79
1135729,68,3,0,0,0,0,0,71
1135730,60,3,0,0,0,0,0,63
1135731,68,5,0,3,0,0,0,76
1135732,60,3,0,0,0,0,0,63
1135733,76,3,3,3,0,0,0,85
1135734,71,3,0,0,0,0,0,74
1135735,76,0,0,0,0,0,0,76
1135736,73,0,0,0,0,0,0,73
1135737,43,4,3,0,0,3,0,53
1135738,59,4,3,0,0,0,0,66
1135739,71,3,0,3,0,0,0,77
1135740,37,7,0,0,0,0,0,44
1135741,63,3,0,0,0,0,0,66
1135742,49,3,0,3,0,0,0,55
1135743,50,0,3,0,0,0,0,53
1135744,56,0,3,3,0,3,0,65
1135745,55,0,0,0,0,0,0,55
1135746,46,3,3,0,0,0,0,52
1135747,42,0,3,3,0,0,0,48
1135748,44,0,0,0,0,0,0,44
1135749,0,0,0,0,0,0,0,0
1135750,49,5,4,0,0,0,0,58
1135751,21,0,3,0,0,0,0,24
1135752,53,3,3,0,0,0,0,59
1135753,57,0,0,0,0,0,0,57
1135754,29,0,3,0,0,0,0,32
1135755,36,4,0,0,0,0,0,40
1135756,39,0,0,0,0,0,0,39
1135757,30,0,3,0,0,0,0,33
1135758,26,3,0,0,0,0,0,29
1135801,43,7,0,0,0,0,0,50
1135802,36,3,0,0,0,0,0,39
1135803,48,7,3,0,0,0,0,58
1135804,88,9,3,0,0,0,0,100
1135805,42,0,3,3,0,0,0,48
1135806,3,0,0,0,0,0,0,3
1135807,25,3,3,0,0,0,0,31
1135808,63,7,0,0,0,0,0,70
1135809,63,5,0,0,0,0,0,68
1135810,78,4,3,0,0,0,0,85
1135811,42,6,3,0,0,0,0,51
1135812,49,3,3,0,0,0,0,55
1135813,41,0,3,0,0,0,0,44
1135814,57,8,0,0,0,0,0,65
1135815,34,5,3,0,0,0,0,42
1135816,50,3,0,0,0,0,3,56
1135817,0,0,0,0,0,0,0,0
1135818,49,4,0,0,0,0,0,53
1135819,44,3,3,0,0,0,0,50
1135820,70,4,0,0,0,0,0,74
1135821,64,4,4,0,0,0,0,72
1135822,26,0,0,0,0,0,0,26
1135823,85,0,6,0,0,0,0,91
1135824,40,0,0,0,0,0,0,40
1135825,12,0,0,0,0,0,0,12
1135826,20,0,3,0,0,0,0,23
1135827,77,3,0,0,0,0,0,80
1135828,49,8,3,0,0,0,0,60
1135829,42,3,4,3,0,0,0,52
1135830,50,0,4,0,0,0,0,54
1135831,46,4,0,0,0,0,0,50
1135832,29,9,0,0,0,0,0,38
1135833,43,3,0,0,0,0,0,46
1135834,39,3,0,0,0,3,0,45
1135835,0,0,0,0,0,0,0,0
1135836,52,0,3,4,0,0,0,59
1135837,29,3,0,0,0,0,0,32
1135838,55,0,3,0,0,0,3,61
1135839,53,5,3,0,0,0,0,61
1135840,44,3,3,0,0,0,3,53
1135841,50,4,0,0,0,0,0,54
1135842,66,8,0,0,0,0,0,74
1135901,54,3,3,0,0,0,3,63
1135902,37,3,0,0,0,0,0,40
1135903,35,7,3,0,0,0,0,45
1135904,38,0,3,0,0,0,0,41
1135905,67,3,4,0,0,0,0,74
1135906,49,3,0,0,0,0,0,52
1135907,48,4,0,0,0,0,0,52
1135908,64,6,0,0,0,0,0,70
1135909,52,3,3,0,0,0,0,58
1135910,0,0,0,0,0,0,0,0
1135911,76,3,3,0,0,0,0,82
1135912,55,4,4,0,0,0,0,63
1135913,47,0,0,0,0,0,0,47
1135914,52,3,3,0,0,0,0,58
1135915,79,4,4,0,0,0,0,87
1135916,56,0,0,0,0,0,0,56
1135917,42,3,0,3,0,0,0,48
1135918,43,6,4,0,0,0,0,53
1135919,47,3,3,3,0,0,0,56
1135920,29,0,3,0,0,0,0,32
1135921,44,4,0,0,0,0,0,48
1135922,0,0,0,0,0,0,0,0
1135923,71,3,3,0,0,0,0,77
1135924,93,3,0,0,0,0,0,96
1135925,66,4,5,0,0,0,0,75
1135926,83,0,0,0,0,0,0,83
1135927,50,0,3,0,0,0,0,53
1135928,38,0,3,0,0,0,3,44
1135929,60,0,3,0,0,0,0,63
1135930,62,0,3,3,0,0,0,68
1135931,62,3,0,3,0,0,0,68
1135932,61,3,0,3,0,0,0,67
1135933,64,4,3,0,0,0,0,71
1135934,75,3,0,0,0,0,0,78
1135935,57,4,3,0,0,0,0,64
1135936,42,3,3,0,0,0,0,48
1135937,63,5,0,0,0,0,0,68
1135938,50,0,3,3,0,0,0,56
1135939,45,3,3,0,0,0,0,51
1135940,40,3,4,0,0,0,0,47
1135941,0,0,0,0,0,0,0,0
1135942,75,3,0,0,0,0,0,78
1135943,52,3,5,0,0,0,0,60
1135944,61,5,0,0,0,0,0,66
1135945,67,5,3,0,0,0,0,75
1135946,42,6,0,3,0,0,0,51
1135947,74,0,6,0,0,0,0,80
1135948,49,0,0,0,0,0,0,49
1135949,73,6,3,0,0,0,3,85
1135950,55,3,3,0,0,0,0,61
1135951,36,0,0,0,0,0,0,36
1135952,0,0,0,0,0,0,0,0
1135953,51,0,0,0,0,0,0,51
1135954,86,6,3,3,0,0,0,98
1135955,54,3,5,0,0,0,0,62
1135956,64,0,0,0,3,0,0,67
1135957,58,6,0,0,0,0,0,64
1135958,37,0,3,0,0,0,0,40
1135959,54,4,4,0,0,0,0,62
1135960,57,4,0,0,0,0,0,61
1135961,38,3,3,3,0,0,0,47
1136001,65,4,0,0,0,0,0,69
1136002,55,7,3,0,0,0,0,65
1136003,68,3,3,3,0,0,0,77
1136004,50,3,3,0,0,0,0,56
1136005,49,3,0,0,0,0,0,52
1136006,43,0,0,0,0,0,0,43
1136007,54,3,3,0,0,0,0,60
1136008,48,3,3,0,0,0,0,54
1136009,63,0,0,0,0,0,0,63
1136010,37,3,4,0,0,0,0,44
1136011,37,3,0,0,0,0,0,40
1136012,44,3,3,0,0,0,3,53
1136013,33,0,0,0,0,0,0,33
1136014,78,4,3,0,0,0,0,85
1136015,45,6,0,0,0,0,0,51
1136016,87,4,4,4,0,0,0,99
1136017,73,3,0,0,0,0,0,76
1136018,76,10,3,0,0,0,0,89
1136019,65,5,3,0,0,0,3,76
1136020,25,3,0,0,0,0,0,28
1136021,40,0,3,0,0,0,0,43
1136022,37,4,0,0,0,0,0,41
1136023,46,0,3,0,0,0,0,49
1136024,52,6,0,0,0,0,0,58
1136025,26,3,3,0,0,0,0,32
1136026,61,3,0,0,0,0,0,64
1136027,84,3,3,0,0,0,0,90
1136028,21,0,3,0,0,0,0,24
1136029,69,3,3,0,0,0,3,78
1136030,60,4,0,0,0,0,0,64
1136031,34,3,0,0,0,0,0,37
1136032,56,7,4,0,0,0,0,67
1136033,49,7,0,0,0,0,0,56
1136034,37,0,0,0,0,0,0,37
1136035,53,3,0,0,0,0,0,56
1136101,50,0,0,0,0,0,0,50
1136102,0,0,0,0,0,0,0,0
1136103,30,3,0,0,0,0,0,33
1136104,83,0,0,0,0,0,0,83
1136105,41,0,3,0,0,0,0,44
1136106,37,0,3,0,0,0,0,40
1136107,46,5,0,0,0,0,0,51
1136108,55,4,3,0,3,0,0,65
1136109,47,3,0,3,0,0,0,53
1136110,44,3,0,0,0,0,0,47
1136111,20,3,3,3,0,0,0,29
1136112,61,0,0,3,0,0,0,64
1136113,61,0,0,0,0,0,0,61
1136114,56,3,0,0,0,0,0,59
1136115,56,0,0,0,0,0,0,56
1136116,32,0,4,0,0,0,0,36
1136117,71,5,0,0,0,0,0,76
1136118,50,0,0,0,0,0,0,50
1136119,43,0,0,0,0,0,0,43
1136120,48,0,0,0,0,0,0,48
1136121,52,7,0,0,0,0,0,59
1136122,65,3,3,3,0,0,0,74
1136123,36,3,0,0,0,0,3,42
1136124,65,0,3,3,0,0,0,71
1136125,44,0,0,0,0,0,0,44
1136126,74,0,0,6,0,0,0,80
1136127,69,4,4,0,0,0,0,77
1136128,47,0,3,0,0,0,0,50
1136129,59,0,3,3,0,0,0,65
1136130,45,0,0,0,0,0,0,45
1136131,43,0,3,0,0,0,0,46
1136132,69,4,0,0,0,0,0,73
1136133,55,4,4,0,0,0,0,63
1136134,81,4,0,0,0,0,0,85
1136135,43,0,0,5,0,0,0,48
1136136,42,4,0,0,0,0,0,46
1136137,57,3,0,3,0,0,0,63
1136138,44,3,4,0,0,0,0,51
1136139,45,0,3,0,0,0,0,48
1136140,70,0,0,3,0,0,0,73
1136141,59,0,0,0,0,0,0,59
1136142,80,3,3,3,0,0,3,92
1136143,26,0,3,0,0,0,0,29
1136144,24,0,0,3,0,0,0,27
1136145,46,5,3,0,0,0,0,54
1136146,45,0,3,3,0,0,0,51
1136201,20,0,0,0,0,0,0,20
1136202,32,3,0,0,0,0,0,35
1136203,38,3,0,3,0,0,0,44
1136204,46,7,3,0,0,0,0,56
1136205,57,4,0,0,0,0,0,61
1136206,41,3,4,0,0,0,0,48
1136207,86,4,3,0,0,0,0,93
1136208,45,3,0,0,0,0,0,48
1136209,67,0,0,4,0,0,0,71
1136210,50,3,0,3,0,0,3,59
1136211,57,3,5,0,0,0,0,65
1136212,64,10,0,0,0,0,0,74
1136213,64,4,0,0,0,0,0,68
1136214,40,0,0,0,0,0,0,40
1136215,43,0,4,0,0,0,0,47
1136216,57,0,0,0,0,0,0,57
1136217,56,3,0,3,0,0,0,62
1136218,51,5,3,0,0,0,0,59
1136219,77,5,3,0,0,0,0,85
1136220,66,3,0,3,0,0,0,72
1136221,70,3,0,5,0,0,0,78
1136222,51,5,0,0,0,0,0,56
1136223,49,4,0,3,0,0,0,56
1136224,47,0,0,0,0,0,0,47
1136225,65,4,0,0,0,0,0,69
1136226,50,3,0,0,0,0,0,53
1136227,82,3,3,0,0,0,0,88
1136228,71,0,0,6,0,0,0,77
1136229,56,6,3,3,0,0,0,68
1136230,80,3,0,0,0,0,0,83
1136231,45,0,0,0,0,0,0,45
1136232,58,3,3,3,0,0,0,67
1136233,54,0,3,3,0,0,0,60
1136234,49,4,0,0,0,0,0,53
1136235,90,11,0,0,0,0,0,101
1136236,32,5,3,0,0,0,0,40
1136237,22,0,0,0,0,0,0,22
1136238,47,0,0,0,0,0,0,47
1136239,59,5,0,0,0,0,0,64
1136240,40,0,0,0,0,0,0,40
1136241,12,6,0,3,0,0,0,21
1136242,30,0,0,0,0,0,0,30
1136243,43,3,0,0,0,0,0,46
1136301,37,3,0,0,0,0,0,40
1136302,68,8,0,0,0,0,0,76
1136303,77,5,0,0,0,0,0,82
1136304,55,4,0,0,0,0,0,59
1136305,52,0,0,0,0,0,0,52
1136306,33,4,0,0,0,0,0,37
1136307,41,0,0,0,0,0,3,44
1136308,58,4,0,0,3,0,0,65
1136309,54,4,0,0,0,0,0,58
1136310,55,5,3,3,0,0,0,66
1136311,51,3,0,5,0,0,0,59
1136312,33,0,0,4,0,0,0,37
1136313,49,3,0,0,0,0,0,52
1136314,38,4,0,0,0,0,0,42
1136315,68,0,5,0,0,0,0,73
1136316,60,3,0,0,0,0,0,63
1136317,40,8,0,0,0,0,3,51
1136318,76,4,0,4,0,0,0,84
1136319,63,4,0,0,0,0,0,67
1136320,84,7,0,0,0,0,0,91
1136321,47,3,3,0,0,0,3,56
1136322,57,4,0,0,0,0,0,61
1136323,47,4,0,4,0,0,0,55
1136324,56,6,0,0,0,0,0,62
1136325,50,0,0,0,0,0,0,50
1136326,52,0,0,0,0,0,0,52
1136327,49,9,0,0,0,0,0,58
1136328,53,8,0,0,0,0,0,61
1136329,58,5,0,0,0,0,0,63
1136330,60,0,5,0,0,0,0,65
1136331,35,0,0,0,0,0,0,35
1136332,34,4,0,0,0,0,0,38
1136333,36,4,0,0,0,0,0,40
1136334,50,5,0,0,0,0,0,55
1136335,53,3,3,3,0,0,0,62
1136336,71,6,3,0,0,0,0,80
1136337,39,5,0,0,0,0,0,44
1136338,50,3,0,0,0,0,0,53
1136339,28,0,0,4,0,0,0,32
1136340,39,0,0,0,0,0,0,39
1136341,44,3,3,0,0,0,0,50
1136342,62,5,0,6,0,0,0,73
1136343,43,0,0,0,0,0,0,43
1136344,69,3,3,4,0,0,0,79
1136345,70,4,0,0,0,0,0,74
1136346,72,4,4,0,0,0,0,80
1136347,58,5,0,0,0,0,0,63
1136348,0,0,0,0,0,0,0,0
1136349,43,0,3,0,0,0,0,46
1136350,78,3,0,0,0,0,0,81
1136351,53,10,0,0,0,0,3,66
1136352,30,3,0,3,0,0,0,36
1136353,35,6,0,0,0,0,0,41
1136354,28,3,0,0,0,0,0,31
1136355,31,0,0,3,0,0,0,34
1136356,20,0,3,0,0,0,0,23
1136357,28,3,3,0,0,0,0,34
1136358,51,7,5,0,0,0,0,63
1136359,28,5,0,0,0,0,0,33
1136360,31,0,0,0,0,0,0,31
1136361,36,3,3,0,0,0,0,42
1136362,31,5,0,0,0,0,0,36
1136363,46,0,4,3,0,0,0,53
1136364,46,4,4,0,0,0,0,54
1136365,39,3,0,3,0,0,0,45
1136366,28,4,0,0,0,0,0,32
1136367,17,3,0,0,0,0,0,20
1136401,40,0,0,4,0,0,0,44
1136402,81,3,3,0,0,0,0,87
1136403,52,3,3,0,0,0,0,58
1136404,29,4,0,0,0,0,0,33
1136405,53,6,3,0,0,0,0,62
1136406,60,3,3,3,0,0,0,69
1136407,71,3,3,0,0,0,0,77
1136408,35,0,0,0,0,0,0,35
1136409,39,3,3,0,0,0,0,45
1136410,49,0,0,0,0,0,0,49
1136411,49,0,3,0,0,0,0,52
1136412,53,4,0,0,0,0,0,57
1136413,48,3,3,0,0,0,0,54
1136414,73,3,3,0,0,0,0,79
1136415,68,3,0,0,0,0,0,71
1136416,78,3,3,0,0,0,0,84
1136417,68,0,3,0,0,0,0,71
1136418,35,3,0,0,0,0,0,38
1136419,27,0,3,0,0,0,0,30
1136420,42,5,3,0,0,0,0,50
1136421,45,0,3,0,0,0,0,48
1136422,67,3,0,0,0,0,0,70
1136423,38,3,0,3,0,0,0,44
1136424,34,3,3,0,0,0,0,40
1136425,33,3,0,0,0,0,0,36
1136426,44,0,0,0,0,0,0,44
1136427,46,0,5,0,0,0,0,51
1136428,83,3,0,3,0,0,0,89
1136429,0,0,0,0,0,0,0,0
1136430,73,3,3,0,0,0,0,79
1136431,83,4,0,3,0,0,0,90
1136432,39,0,0,0,0,0,0,39
1136433,79,4,3,0,0,0,0,86
1136434,32,4,0,0,0,0,0,36
1136435,63,3,3,0,0,0,0,69
1136436,90,3,0,0,0,0,0,93
1136437,65,0,0,0,0,0,0,65
1136438,76,10,0,0,0,0,0,86
1136439,54,3,0,0,0,0,0,57
1136440,79,0,3,0,0,0,0,82
1136441,56,3,0,0,0,0,0,59
1136442,67,0,0,0,0,0,0,67
1136443,50,4,4,0,0,0,0,58
1136444,57,3,3,0,0,0,0,63
1136445,54,0,0,0,0,0,0,54
1136446,89,4,0,0,0,0,0,93
1136447,70,3,0,0,0,0,0,73
1136448,37,3,0,0,0,0,0,40
1136449,71,4,0,0,0,0,0,75
1136450,65,3,3,0,0,0,0,71
1136451,32,3,3,0,0,0,0,38
1136452,67,3,0,0,0,0,0,70
1136453,27,3,0,0,0,0,0,30
1136454,23,0,0,0,0,0,0,23
1136455,41,0,0,0,0,0,0,41
1136456,56,5,0,0,0,0,0,61
1136457,53,5,0,0,0,0,0,58
1136458,42,3,3,0,0,0,0,48
1136501,82,5,3,3,0,0,0,93
1136502,78,5,0,0,0,0,0,83
1136503,46,0,0,0,0,0,0,46
1136504,71,3,0,0,0,0,3,77
1136505,73,0,0,3,0,0,0,76
1136506,67,0,5,0,0,0,0,72
1136507,50,5,0,0,0,0,0,55
1136508,49,0,3,0,0,0,0,52
1136509,37,3,3,0,0,0,0,43
1136510,50,3,3,0,0,0,0,56
1136511,90,3,3,7,0,0,0,103
1136512,60,0,0,3,0,0,0,63
1136513,72,3,0,3,0,0,0,78
1136514,57,0,0,0,0,0,0,57
1136515,77,0,3,3,0,0,0,83
1136516,37,0,0,0,0,0,0,37
1136517,38,3,0,0,0,0,0,41
1136518,80,7,0,5,0,0,0,92
1136519,76,3,5,0,0,0,0,84
1136520,51,7,5,0,0,0,0,63
1136521,40,3,3,3,0,0,0,49
1136522,61,5,4,0,0,0,0,70
1136523,75,3,0,0,0,0,0,78
1136524,79,0,0,0,0,0,0,79
1136525,69,0,5,0,0,0,0,74
1136526,51,3,0,0,0,0,0,54
1136527,61,0,0,0,0,0,0,61
1136528,67,5,4,0,0,0,0,76
1136529,68,4,3,0,0,0,0,75
1136530,68,3,0,0,0,0,0,71
1136531,40,6,0,0,0,0,0,46
1136532,82,8,0,0,0,0,0,90
1136533,62,4,0,0,0,0,0,66
1136534,40,0,0,0,0,0,0,40
1136535,63,4,0,0,0,0,0,67
1136536,83,4,3,3,0,0,0,93
1136537,66,4,3,0,0,0,0,73
1136538,67,3,0,0,0,0,0,70
1136539,41,4,0,0,0,0,0,45
1136540,61,0,0,3,0,0,0,64
1136541,52,4,0,0,0,0,0,56
1136542,71,3,0,3,0,0,0,77
1136543,52,0,4,0,0,0,0,56
1136544,58,3,0,0,0,0,0,61
1136545,47,0,4,0,0,0,0,51
1136546,37,3,4,0,0,0,0,44
1136547,57,3,0,3,0,0,0,63
1136548,80,0,0,5,0,0,0,85
1136549,100,3,0,0,0,0,0,103
1136550,61,4,3,0,0,0,0,68
1136551,54,0,3,0,0,0,0,57
1136552,34,0,3,0,0,0,3,40
1136601,44,3,0,3,0,0,0,50
1136602,66,4,4,0,0,0,0,74
1136603,43,6,3,0,0,0,0,52
1136604,67,3,3,3,0,0,0,76
1136605,53,0,0,0,0,0,0,53
1136606,59,3,0,0,0,0,3,65
1136607,56,3,0,0,0,0,0,59
1136608,43,3,0,3,0,0,0,49
1136609,63,3,3,3,0,0,0,72
1136610,49,6,3,3,0,0,0,61
1136611,35,0,4,0,0,0,0,39
1136612,52,0,0,3,0,0,0,55
1136613,38,0,3,0,0,0,0,41
1136614,34,0,0,0,0,0,0,34
1136615,70,3,0,0,0,0,0,73
1136616,51,3,0,0,0,0,0,54
1136617,44,0,0,0,0,0,0,44
1136618,61,4,0,4,0,0,0,69
1136619,18,0,3,3,0,0,0,24
1136620,40,9,0,0,0,0,0,49
1136621,78,3,3,3,0,0,0,87
1136622,43,0,0,0,0,0,0,43
1136623,63,0,0,0,0,0,0,63
1136624,60,3,0,3,0,3,0,69
1136625,41,3,3,0,0,0,0,47
1136626,68,3,3,3,0,0,0,77
1136627,54,0,4,4,0,0,0,62
1136628,54,0,0,0,0,0,3,57
1136629,78,0,3,3,0,0,0,84
1136630,43,3,0,4,0,0,0,50
1136631,55,4,0,0,0,0,0,59
1136632,60,0,0,4,0,0,0,64
1136633,39,0,0,0,0,0,0,39
1136634,63,5,3,0,0,0,0,71
1136635,57,0,0,0,0,0,0,57
1136636,75,3,0,3,0,0,0,81
1136637,58,6,3,0,0,0,0,67
1136638,64,3,3,3,0,0,3,76
1136639,43,4,0,0,0,0,0,47
1136640,52,0,3,0,0,0,0,55
1136641,0,0,0,0,0,0,0,0
1136642,59,3,3,5,0,0,0,70
1136643,55,6,0,0,0,0,0,61
1136644,3,0,0,0,0,0,0,3
1136645,55,3,0,0,0,0,3,61
1136646,46,3,0,0,0,0,0,49
1136647,34,0,4,3,0,0,0,41
1136648,29,3,3,0,0,0,0,35
1136701,51,3,3,3,0,0,0,60
1136702,60,0,4,4,0,0,0,68
1136703,42,4,0,0,0,0,3,49
1136704,64,3,3,0,0,0,0,70
1136705,28,3,3,0,0,0,0,34
1136706,39,0,0,4,0,0,0,43
1136707,69,0,3,3,0,0,0,75
1136708,57,4,0,0,0,0,0,61
1136709,52,5,0,0,0,0,0,57
1136710,33,0,0,0,0,3,0,36
1136711,57,0,0,0,0,0,0,57
1136712,60,3,3,0,0,0,0,66
1136713,83,0,4,0,0,0,0,87
1136714,49,4,0,4,0,0,0,57
1136715,52,4,0,0,0,0,0,56
1136716,59,3,3,0,0,0,0,65
1136717,65,0,0,0,0,0,0,65
1136718,67,3,0,3,0,3,0,76
1136719,57,3,0,0,0,0,0,60
1136720,86,3,0,0,0,0,0,89
1136721,58,0,7,0,0,0,0,65
1136722,71,3,0,0,3,0,0,77
1136723,70,3,0,0,0,0,0,73
1136724,86,3,3,7,0,0,0,99
1136725,83,3,3,0,0,0,0,89
1136726,78,0,3,0,0,0,0,81
1136727,76,0,3,3,0,0,0,82
1136728,63,3,0,3,0,0,0,69
1136801,34,0,0,0,0,0,0,34
1136802,45,3,0,0,0,0,0,48
1136803,39,3,0,3,0,0,0,45
1136804,29,3,3,0,0,0,0,35
1136805,28,0,0,0,0,0,0,28
1136806,48,6,0,0,0,3,0,57
1136807,36,3,0,0,0,0,0,39
1136808,43,3,3,0,0,0,0,49
1136809,73,3,0,3,0,0,0,79
1136810,57,0,0,0,0,0,0,57
1136811,60,0,0,3,0,0,0,63
1136812,79,6,0,0,0,0,0,85
1136813,75,0,0,0,0,0,0,75
1136814,59,3,0,0,0,0,0,62
1136815,79,4,0,5,0,0,0,88
1136816,38,4,0,0,0,0,0,42
1136817,65,3,0,3,0,0,0,71
1136818,57,0,3,3,0,0,0,63
1136819,76,4,3,3,0,0,0,86
1136820,84,4,3,0,0,0,3,94
1136821,55,3,0,0,0,0,0,58
1136822,43,5,0,0,0,0,0,48
1136823,32,0,0,0,0,0,0,32
1136824,56,6,0,3,0,0,0,65
1136825,44,7,3,4,0,0,0,58
1136826,81,0,0,3,0,0,0,84
1136827,44,0,0,0,0,0,0,44
1136828,45,0,0,0,0,0,0,45
1136829,59,4,0,0,0,0,0,63
1136830,33,4,3,0,0,0,0,40
1136831,38,0,3,0,0,0,0,41
1136832,62,3,0,0,0,0,0,65
1136833,58,3,0,3,0,0,0,64
1136834,64,4,0,3,0,0,0,71
1136835,64,3,3,0,0,0,0,70
1136836,44,0,3,0,0,0,0,47
1136837,46,6,0,0,0,0,4,56
1136838,57,6,0,0,0,0,0,63
1136839,64,4,0,0,0,0,0,68
1136840,58,3,3,0,0,0,0,64
1136841,83,3,0,0,0,0,0,86
1136842,60,3,0,3,0,0,0,66
1136843,81,3,3,0,0,0,0,87
1136901,46,0,3,0,0,0,0,49
1136902,51,7,3,0,0,0,0,61
1136903,37,3,0,0,0,0,0,40
1136904,0,0,0,0,0,0,0,0
1136905,26,3,0,0,0,0,0,29
1136906,37,0,0,0,0,0,0,37
1136907,40,3,0,0,0,0,0,43
1136908,35,3,0,0,0,0,0,38
1136909,66,5,0,0,0,0,0,71
1136910,75,3,5,3,0,0,0,86
1136911,79,7,0,0,0,0,0,86
1136912,55,4,0,0,0,0,0,59
1136913,59,0,0,0,0,0,0,59
1136914,92,6,0,0,0,0,0,98
1136915,54,3,0,0,0,0,0,57
1136916,67,0,0,0,0,0,0,67
1136917,65,0,0,3,0,0,0,68
1136918,75,3,0,4,0,0,0,82
1136919,42,3,6,0,0,0,0,51
1136920,32,0,0,0,0,0,0,32
1136921,44,3,0,0,0,0,0,47
1136922,72,3,3,0,0,0,0,78
1136923,80,0,0,0,0,0,0,80
1136924,23,6,5,0,0,0,0,34
1136925,55,8,0,0,0,0,0,63
1136926,38,4,0,0,0,0,0,42
1136927,66,3,7,0,0,0,0,76
1136928,81,0,3,3,0,0,0,87
1136929,62,3,0,3,0,0,0,68
1136930,44,0,3,3,0,0,0,50
1136931,51,4,4,0,0,0,0,59
1136932,50,3,3,0,0,0,0,56
1136933,82,0,5,0,0,0,0,87
1136934,40,0,0,0,0,0,0,40
1136935,66,12,0,6,0,0,0,84
1136936,66,3,0,0,0,0,0,69
1136937,69,4,0,3,0,0,0,76
1136938,44,8,0,0,0,0,0,52
1136939,56,3,0,3,0,0,0,62
1136940,40,3,0,3,0,0,0,46
1136941,49,5,0,0,0,0,0,54
1136942,77,3,4,0,0,0,0,84
1136943,43,4,0,0,0,0,0,47
1136944,54,0,0,0,0,0,0,54
1136945,74,3,3,5,0,0,0,85
1136946,73,0,0,0,0,0,0,73
1136947,0,0,0,0,0,0,0,0
1136948,59,8,3,0,0,0,0,70
1136949,24,0,4,3,0,0,3,34
1136950,86,3,0,0,0,0,3,92
1137001,26,0,0,0,0,0,0,26
1137002,57,4,3,3,0,0,0,67
1137003,44,0,0,0,0,0,0,44
1137004,42,0,0,0,0,0,0,42
1137005,39,0,0,0,0,0,0,39
1137006,48,3,0,3,0,0,0,54
1137007,40,3,0,0,0,0,0,43
1137008,32,4,0,0,0,0,0,36
1137009,51,4,3,0,0,0,0,58
1137010,66,0,0,4,0,0,0,70
1137011,74,8,3,0,0,0,0,85
1137012,35,3,3,0,0,0,0,41
1137013,29,3,0,0,0,0,0,32
1137014,53,3,0,3,0,0,0,59
1137015,32,5,4,0,0,0,0,41
1137016,26,0,0,3,0,0,0,29
1137017,57,0,3,0,0,0,0,60
1137018,84,3,3,0,0,3,0,93
1137019,102,0,0,5,0,0,0,107
1137020,53,5,4,0,0,0,0,62
1137021,42,4,0,0,0,0,0,46
1137022,43,0,0,0,0,0,0,43
1137023,48,0,0,0,0,0,0,48
1137024,70,5,0,0,0,0,0,75
1137025,75,4,3,0,0,0,0,82
1137026,87,3,0,3,0,0,0,93
1137027,47,0,5,0,0,0,0,52
1137028,70,3,0,0,0,0,0,73
1137029,57,0,0,3,0,0,0,60
1137030,43,0,3,0,0,0,0,46
1137101,48,0,3,0,0,0,0,51
1137102,45,3,3,0,0,0,0,51
1137103,34,3,0,0,0,0,0,37
1137104,63,3,0,0,0,0,0,66
1137105,60,0,0,0,0,0,0,60
1137106,22,0,0,0,0,0,0,22
1137107,86,3,3,3,0,0,0,95
1137108,90,3,0,0,0,0,0,93
1137109,77,5,0,0,0,0,0,82
1137110,85,3,0,0,0,0,0,88
1137111,39,3,0,0,0,0,0,42
1137112,57,3,0,0,0,0,0,60
1137113,73,0,0,0,0,0,0,73
1137114,40,3,3,0,0,0,0,46
1137115,66,3,3,3,0,0,0,75
1137116,50,0,0,4,0,0,0,54
1137117,47,0,0,0,0,0,0,47
1137118,64,6,3,0,0,0,0,73
1137119,67,3,3,3,0,0,0,76
1137120,84,6,0,0,0,0,0,90
1137121,64,3,3,0,0,0,0,70
1137122,54,3,0,0,0,0,0,57
1137123,34,0,0,0,0,0,0,34
1137124,24,0,0,0,0,0,0,24
1137125,53,3,3,0,0,0,0,59
1137126,38,3,3,0,0,0,0,44
1137127,47,3,0,0,0,0,0,50
1137128,61,0,3,0,0,0,0,64
1137129,58,0,0,0,0,0,0,58
1137130,58,3,0,0,0,0,0,61
1137131,33,0,0,3,0,0,0,36
1137201,87,3,3,0,0,0,3,96
1137202,86,3,3,0,0,0,0,92
1137203,63,4,3,0,0,0,0,70
1137204,0,0,0,0,0,0,0,0
1137205,38,3,4,0,0,0,0,45
1137206,65,9,5,0,0,0,0,79
1137207,47,4,0,0,0,0,0,51
1137208,59,5,0,0,0,0,0,64
1137209,0,0,0,0,0,0,0,0
1137210,39,3,3,0,0,0,0,45
1137211,49,0,0,0,0,0,0,49
1137212,56,6,0,0,0,0,0,62
1137213,77,8,0,0,0,0,0,85
1137214,70,5,0,0,0,0,0,75
1137215,51,3,0,0,0,0,0,54
1137216,58,6,0,0,0,0,0,64
1137217,19,3,0,0,0,0,0,22
1137218,75,3,3,3,0,0,0,84
1137219,76,4,0,0,0,0,0,80
1137220,43,3,3,0,0,0,0,49
1137221,64,3,3,3,0,0,0,73
1137222,37,6,3,0,0,0,0,46
1137223,69,3,0,0,0,0,0,72
1137224,43,0,0,0,0,0,0,43
1137225,46,0,0,5,0,0,0,51
1137226,36,3,0,0,0,0,0,39
1137227,15,3,4,0,0,0,0,22
1137228,39,3,4,0,0,0,0,46
1137229,61,0,0,0,0,0,3,64
1137230,84,3,3,0,0,0,3,93
1137231,72,4,6,0,0,0,0,82
1137232,67,7,4,0,0,0,0,78
1137233,31,4,0,0,0,0,0,35
1137234,47,0,0,0,0,0,0,47
1137235,36,3,0,0,0,0,0,39
1137236,49,0,0,0,0,0,0,49
1137237,65,3,3,0,0,0,3,74
1137238,82,4,0,0,0,0,0,86
1137239,35,4,0,4,0,0,0,43
1137240,50,3,0,0,0,0,0,53
1137241,45,0,0,0,0,0,0,45
1137242,44,0,4,0,0,0,0,48
1137243,39,0,0,0,0,0,0,39
1137244,49,0,0,0,0,0,0,49
1137245,45,0,3,0,0,0,3,51
1137301,28,3,0,0,0,0,0,31
1137302,71,5,3,3,0,0,3,85
1137303,65,5,4,0,0,4,0,78
1137304,73,11,0,4,0,0,0,88
1137305,29,3,0,3,0,0,3,38
1137306,46,3,0,0,0,0,0,49
1137307,0,0,0,0,0,0,0,0
1137308,25,0,4,0,0,0,0,29
1137309,13,3,3,0,3,0,0,22
1137310,9,0,0,0,0,0,0,9
1137311,0,0,0,0,0,0,0,0
1137312,3,3,0,0,0,0,0,6
1137313,28,3,0,0,0,0,0,31
1137314,15,0,0,0,0,0,0,15
1137315,0,0,0,0,0,0,0,0
1137316,90,4,0,0,0,0,0,94
1137317,45,3,4,0,0,0,0,52
1137318,64,0,3,0,0,3,0,70
1137319,59,0,0,0,0,0,0,59
1137320,21,0,3,3,0,0,0,27
1137321,31,5,0,0,0,0,0,36
1137322,59,0,0,0,0,0,0,59
1137323,71,3,0,3,0,0,0,77
1137324,36,9,0,3,0,0,0,48
1137325,62,3,3,3,0,0,0,71
1137401,46,5,0,0,0,0,0,51
1137402,69,0,3,3,0,0,0,75
1137403,35,3,4,3,0,0,0,45
1137404,29,0,3,0,0,0,0,32
1137405,40,0,0,0,0,0,0,40
1137406,90,8,0,3,0,0,3,104
1137407,43,0,3,0,0,0,0,46
1137408,59,6,0,0,0,0,0,65
1137409,53,0,0,5,0,0,0,58
1137410,42,0,3,0,0,0,0,45
1137411,29,6,0,0,0,0,0,35
1137412,34,4,0,0,0,0,0,38
1137413,55,9,0,0,0,0,0,64
1137414,56,3,0,3,0,0,0,62
1137415,32,0,0,0,0,0,0,32
1137416,55,0,4,0,0,0,0,59
1137417,81,0,0,5,0,0,0,86
1137418,54,3,3,0,0,0,0,60
1137419,53,4,0,0,0,0,0,57
1137420,23,3,0,0,0,0,0,26
1137421,58,6,4,0,0,0,0,68
1137422,42,3,0,0,0,0,0,45
1137423,40,5,0,0,0,0,0,45
1137424,32,5,0,0,0,0,0,37
1137425,27,0,0,0,0,0,0,27
1137426,32,3,0,0,0,0,0,35
1137427,56,4,4,0,0,0,0,64
1137428,33,3,0,0,0,0,0,36
1137429,77,4,0,0,0,0,0,81
1137430,70,6,0,0,0,3,0,79
1137431,41,3,0,0,0,0,0,44
1137432,43,3,0,0,0,0,0,46
1137433,65,3,4,3,0,0,0,75
1137434,51,3,5,0,0,0,0,59
1137435,41,0,0,3,0,0,0,44
1137436,67,0,0,0,0,0,0,67
1137437,87,5,3,3,0,0,0,98
1137438,60,3,3,0,0,0,0,66
1137439,67,6,3,0,0,0,0,76
1137440,30,3,0,3,0,0,0,36
1137441,64,4,0,0,0,0,0,68
1137442,75,3,4,3,0,0,0,85
1137443,62,4,0,0,0,0,0,66
1137444,40,3,0,0,0,0,0,43
1137445,59,0,0,0,0,0,0,59
1137446,64,8,0,0,0,0,0,72
1137447,56,3,0,0,0,0,0,59
1137448,60,0,0,0,0,0,0,60
1137449,50,0,3,0,0,0,0,53
1137450,36,0,0,0,0,0,0,36
1137451,21,0,0,0,0,0,0,21
1137452,73,0,0,0,0,0,0,73
1137453,0,0,0,0,0,0,0,0
1137454,32,3,0,0,0,0,0,35
1137455,34,0,3,0,0,0,0,37
1137456,50,3,0,0,0,0,0,53
1137457,64,0,4,0,0,0,0,68
1137458,75,0,0,4,0,0,0,79
1137501,56,0,3,0,0,0,0,59
1137502,94,0,0,0,0,0,0,94
1137503,62,4,0,0,0,0,0,66
1137504,37,3,0,0,0,0,0,40
1137505,44,5,0,0,0,0,0,49
1137506,32,0,0,0,0,0,0,32
1137507,49,4,0,0,0,0,0,53
1137508,3,0,0,0,0,0,0,3
1137509,41,3,0,0,0,0,0,44
1137510,68,5,0,3,0,0,0,76
1137511,77,0,0,0,0,0,0,77
1137512,73,0,0,0,0,0,0,73
1137513,62,0,4,0,0,0,0,66
1137514,68,4,0,4,0,0,0,76
1137515,19,0,3,0,0,0,0,22
1137516,38,0,3,0,0,0,0,41
1137517,3,0,0,0,0,0,0,3
1137518,75,0,3,3,0,0,4,85
1137519,47,4,0,0,0,0,0,51
1137520,43,4,3,0,0,0,0,50
1137521,0,0,0,0,0,0,0,0
1137522,57,0,0,0,0,0,0,57
1137523,53,3,3,0,0,0,0,59
1137524,45,5,0,0,0,0,0,50
1137525,38,3,0,0,0,0,4,45
1137526,41,4,0,0,0,0,0,45
1137527,27,0,0,0,0,0,0,27
1137528,44,0,3,0,0,0,0,47
1137529,41,3,3,0,0,0,0,47
1137530,28,3,0,0,0,0,0,31
1137531,59,7,0,0,0,0,0,66
1137532,59,4,0,0,0,0,0,63
1137533,54,0,4,0,0,0,0,58
1137534,52,0,0,0,0,0,0,52
1137535,34,0,0,0,0,0,0,34
1137601,43,5,0,0,0,0,0,48
1137602,75,6,3,0,0,0,0,84
1137603,63,0,0,0,0,0,0,63
1137604,39,3,0,0,0,0,0,42
1137605,59,0,3,4,0,0,0,66
1137606,62,0,3,0,0,0,0,65
1137607,38,3,3,3,0,0,0,47
1137608,83,3,0,3,0,0,0,89
1137609,22,0,0,0,0,0,0,22
1137610,66,3,3,0,0,0,0,72
1137611,31,0,4,0,0,0,0,35
1137612,24,0,3,0,0,0,0,27
1137613,46,0,0,5,0,0,0,51
1137614,82,3,0,0,0,0,0,85
1137615,58,3,0,0,0,0,0,61
1137616,53,6,0,3,0,0,0,62
1137617,41,5,0,0,0,0,0,46
1137618,39,0,0,0,0,0,0,39
1137619,42,3,0,3,0,0,0,48
1137620,40,0,0,0,0,0,0,40
1137621,40,3,0,0,0,0,0,43
1137622,46,4,0,0,0,0,0,50
1137623,45,3,0,0,0,0,0,48
1137624,72,4,0,3,0,0,0,79
1137625,69,6,0,0,0,0,0,75
1137626,82,4,0,0,0,0,0,86
1137627,72,5,0,0,0,3,0,80
1137628,78,3,3,0,0,0,0,84
1137629,38,3,0,0,0,0,0,41
1137630,50,5,0,4,0,0,0,59
1137631,43,0,0,0,0,0,0,43
1137632,71,4,3,0,0,0,0,78
1137633,46,3,0,0,0,0,0,49
1137634,53,3,3,0,0,0,0,59
1137635,53,6,0,0,0,0,0,59
1137636,54,6,3,0,0,0,0,63
1137637,41,0,0,0,0,0,0,41
1137638,59,3,3,3,0,0,0,68
1137639,49,8,0,0,0,0,0,57
1137640,71,3,3,0,0,0,0,77
1137641,90,8,0,0,0,0,0,98
1137642,75,0,0,4,0,0,0,79
1137643,63,3,0,0,0,0,0,66
1137644,69,3,3,3,0,0,3,81
1137645,68,0,0,0,0,0,0,68
1137646,32,3,0,0,0,0,0,35
1137647,51,3,3,0,0,0,0,57
1137648,64,0,3,3,0,0,0,70
1137649,53,3,3,0,0,0,0,59
1137650,49,3,0,0,0,0,0,52
1137651,65,3,0,0,0,0,0,68
1137652,51,0,0,0,0,0,0,51
1137653,68,3,0,0,0,0,0,71
1137654,54,6,4,0,0,0,0,64
1137655,52,4,3,0,0,0,0,59
1137656,67,3,4,4,0,0,0,78
1137657,51,0,0,0,0,0,0,51
1137701,41,3,0,0,0,0,0,44
1137702,35,0,3,3,0,0,0,41
1137703,32,0,0,0,0,0,0,32
1137704,46,3,0,3,0,0,0,52
1137705,48,0,3,0,0,0,0,51
1137706,43,0,0,0,0,0,0,43
1137707,63,3,3,3,0,0,0,72
1137708,59,4,4,0,0,0,0,67
1137709,37,3,0,0,0,0,0,40
1137710,47,0,0,0,0,0,0,47
1137711,31,3,0,0,0,0,0,34
1137712,44,0,3,0,0,0,0,47
1137713,37,0,0,4,0,0,0,41
1137714,69,0,0,0,0,0,0,69
1137715,65,0,0,0,0,0,0,65
1137716,48,3,0,0,0,0,0,51
1137717,41,0,0,0,0,0,0,41
1137718,57,0,0,0,0,0,0,57
1137719,45,0,0,0,0,0,0,45
1137720,32,0,0,0,0,0,0,32
1137721,59,0,4,0,0,0,0,63
1137722,66,4,0,0,0,0,0,70
1137723,36,3,0,0,0,0,0,39
1137724,58,0,0,0,0,0,0,58
1137725,49,4,0,0,0,0,0,53
1137726,36,3,3,0,0,0,0,42
1137727,66,0,0,0,0,0,0,66
1137728,63,0,3,3,0,0,0,69
1137729,83,5,3,0,0,0,0,91
1137730,58,0,0,0,0,0,0,58
1137731,37,0,0,0,0,0,0,37
1137732,46,3,0,0,0,0,0,49
1137733,50,4,0,3,0,0,0,57
1137734,55,0,0,0,0,0,0,55
1137801,40,3,0,0,0,0,0,43
1137802,63,3,3,3,0,0,0,72
1137803,49,0,0,4,0,0,0,53
1137804,37,3,0,0,0,0,0,40
1137805,58,0,0,0,0,0,0,58
1137806,53,6,0,0,0,0,0,59
1137807,45,0,0,0,0,0,0,45
1137808,62,0,0,0,0,0,0,62
1137809,0,0,0,0,0,0,0,0
1137810,55,0,0,0,0,0,0,55
1137811,52,3,3,3,0,0,0,61
1137812,0,0,0,0,0,0,0,0
1137813,57,0,3,4,0,0,0,64
1137814,29,0,0,0,0,0,0,29
1137815,0,0,0,0,0,0,0,0
1137816,54,0,0,5,0,0,0,59
1137817,58,4,0,0,0,0,0,62
1137818,30,4,0,0,0,0,0,34
1137819,42,4,0,0,0,3,0,49
1137820,22,3,0,0,0,0,0,25
1137821,41,0,4,0,0,0,0,45
1137822,75,3,0,0,0,0,3,81
1137823,23,0,0,0,0,0,0,23
1137824,24,0,3,3,0,0,0,30
1137825,45,0,0,0,0,0,0,45
1137826,84,3,0,3,0,3,0,93
1137827,32,0,4,0,0,0,0,36
1137901,52,0,0,0,0,0,0,52
1137902,60,8,0,0,0,0,0,68
1137903,72,0,0,0,0,0,0,72
1137904,80,9,4,0,0,0,0,93
1137905,25,3,0,3,0,0,0,31
1137906,55,0,4,0,0,0,0,59
1137907,77,0,0,0,0,0,0,77
1137908,54,0,0,0,0,4,0,58
1137909,43,3,3,3,0,0,0,52
1137910,36,4,0,0,0,0,0,40
1137911,40,0,0,0,0,0,0,40
1137912,85,6,0,0,0,0,0,91
1137913,47,4,3,4,0,0,0,58
1137914,32,0,0,0,0,0,0,32
1137915,47,3,0,0,0,0,0,50
1137916,33,0,3,0,0,0,0,36
1137917,55,0,3,0,0,0,0,58
1137918,79,3,3,3,0,0,0,88
1137919,59,6,0,0,0,0,0,65
1137920,46,3,0,0,0,0,0,49
1137921,43,0,0,0,0,0,0,43
1137922,44,3,3,0,0,0,0,50
1137923,79,5,0,0,0,0,0,84
1137924,44,0,3,0,0,0,0,47
1137925,51,5,4,0,0,0,0,60
1137926,0,0,0,0,0,0,0,0
1137927,41,0,0,0,0,0,0,41
1137928,29,3,0,3,0,0,0,35
1137929,55,3,0,0,0,0,3,61
1137930,60,3,0,0,0,0,0,63
1137931,39,4,0,0,0,0,0,43
1137932,55,0,0,0,0,0,0,55
1137933,73,3,0,0,0,0,0,76
1137934,35,6,0,0,0,0,0,41
1137935,53,0,0,0,0,0,0,53
1137936,43,3,0,0,0,0,0,46
1137937,41,0,3,4,0,0,0,48
1138001,45,3,0,3,0,0,0,51
1138002,61,3,0,0,0,0,0,64
1138003,35,3,0,3,0,0,0,41
1138004,31,4,0,0,0,0,3,38
1138005,45,0,3,0,0,0,0,48
1138006,45,3,0,0,0,0,0,48
1138007,40,3,0,3,0,0,0,46
1138008,68,3,3,0,0,0,0,74
1138009,52,0,0,0,0,0,0,52
1138010,68,3,0,3,3,0,0,77
1138011,35,4,0,0,0,0,0,39
1138012,21,0,0,0,0,0,0,21
1138013,25,3,0,0,0,0,3,31
1138014,27,8,0,0,0,0,0,35
1138015,24,3,0,0,0,0,0,27
1138016,31,0,0,0,0,0,0,31
1138017,41,0,3,0,0,0,0,44
1138018,36,3,3,0,0,0,0,42
1138019,39,0,0,0,0,0,0,39
1138020,63,3,0,0,0,0,3,69
1138021,26,0,0,0,0,0,0,26
1138022,41,3,0,0,0,0,0,44
1138023,40,3,4,4,0,0,0,51
1138024,26,4,0,0,0,0,0,30
1138025,17,3,0,0,0,0,0,20
1138026,46,5,3,0,0,0,0,54
1138027,46,7,3,3,0,0,0,59
1138028,46,4,3,0,0,0,0,53
1138029,35,0,0,0,0,0,0,35
1138030,72,0,3,0,0,0,0,75
1138031,59,5,0,0,0,0,0,64
1138032,30,4,0,0,0,0,0,34
1138101,26,7,3,0,0,0,0,36
1138102,16,0,0,0,0,0,0,16
1138103,19,0,0,0,0,0,0,19
1138104,53,4,0,0,0,0,0,57
1138105,66,3,3,0,0,0,3,75
1138106,36,0,0,0,0,0,0,36
1138107,34,4,0,0,0,0,0,38
1138108,29,4,0,0,0,0,0,33
1138109,55,0,3,3,0,0,0,61
1138110,31,0,0,0,0,0,0,31
1138111,68,4,0,0,0,0,0,72
1138112,37,3,0,0,0,0,0,40
1138113,47,0,0,0,0,0,0,47
1138114,55,3,0,3,0,0,0,61
1138115,0,0,0,0,0,0,0,0
1138116,33,3,0,0,0,0,0,36
1138117,76,4,0,0,0,0,0,80
1138118,71,3,0,0,0,0,3,77
1138119,61,0,0,0,0,0,0,61
1138120,27,3,0,0,0,0,0,30
1138121,43,0,0,0,0,0,0,43
1138122,31,0,0,0,0,0,0,31
1138123,57,5,0,0,0,0,0,62
1138124,46,5,0,0,0,3,0,54
1138125,26,6,0,0,0,0,0,32
1138126,38,6,0,0,0,0,0,44
1138127,28,0,4,0,0,0,0,32
1138128,0,0,0,0,0,0,0,0
1138129,21,0,0,0,0,0,0,21
1138130,74,0,3,3,0,0,0,80
1138131,46,0,0,0,0,0,0,46
1138132,33,0,0,0,0,0,0,33
1138133,53,0,0,0,0,0,0,53
1138134,64,0,0,0,0,0,0,64
1138135,39,3,0,3,0,0,0,45
1138136,55,3,3,0,0,0,0,61
1138137,62,3,3,0,0,0,0,68
1138138,50,3,3,0,0,0,0,56
1138139,0,0,0,0,0,0,0,0
1138140,34,4,0,3,0,0,0,41
1138141,36,0,0,0,0,0,0,36
1138142,26,0,0,0,0,0,0,26
1138143,30,0,0,0,0,0,0,30
1138144,39,3,3,3,0,0,0,48
1138145,47,3,3,0,0,0,0,53
1138146,21,0,0,0,0,0,0,21
1138147,55,0,0,0,0,0,0,55
1138201,28,0,0,0,0,0,0,28
1138202,26,5,3,0,0,0,0,34
1138203,23,3,0,0,0,0,0,26
1138204,32,0,0,0,0,0,0,32
1138205,51,0,4,0,0,0,0,55
1138206,53,3,0,0,0,0,0,56
1138207,41,3,3,0,0,0,0,47
1138208,58,0,0,3,0,0,0,61
1138209,50,5,0,0,0,0,0,55
1138210,56,3,3,0,0,0,0,62
1138211,51,0,0,0,0,0,3,54
1138212,32,5,0,0,0,0,0,37
1138213,14,0,0,0,0,0,0,14
1138214,48,3,0,0,0,0,0,51
1138215,33,0,0,0,0,0,0,33
1138216,20,0,0,0,0,0,0,20
1138217,47,5,0,0,0,0,0,52
1138218,26,0,3,0,0,0,0,29
1138219,57,3,4,0,0,0,0,64
1138220,63,3,0,0,0,0,0,66
1138221,40,5,0,0,0,0,0,45
1138222,64,5,3,3,0,0,0,75
1138223,43,3,3,0,0,0,0,49
1138224,57,3,0,5,0,0,0,65
1138225,28,4,4,0,0,0,0,36
1138226,21,6,0,0,0,0,0,27
1138227,30,3,0,0,0,0,0,33
1138228,35,5,0,0,0,0,0,40
1138229,74,7,0,0,0,0,0,81
1138230,49,6,0,0,0,0,0,55
1138231,30,0,0,0,0,0,0,30
1138232,20,3,0,0,0,0,0,23
1138233,42,0,5,0,0,0,0,47
1138234,49,3,0,3,0,0,0,55
1138235,66,0,0,0,0,0,0,66
1138236,50,0,0,4,0,0,0,54
1138237,36,4,0,0,0,0,0,40
1138238,30,0,0,0,0,0,0,30
1138239,28,0,0,3,0,0,0,31
1138301,40,7,0,0,0,0,0,47
1138302,68,6,0,0,0,0,0,74
1138303,0,0,0,0,0,0,0,0
1138304,45,0,0,3,0,0,0,48
1138305,0,0,0,0,0,0,0,0
1138306,76,0,0,0,0,0,0,76
1138307,83,4,0,0,0,0,0,87
1138308,57,3,0,0,0,0,0,60
1138309,40,3,4,0,0,0,0,47
1138310,63,0,0,0,0,0,0,63
1138311,43,4,0,0,0,0,0,47
1138312,71,0,0,3,0,0,0,74
1138313,56,0,4,0,0,0,0,60
1138314,45,3,0,0,0,0,0,48
1138315,78,0,5,0,0,0,0,83
1138316,51,0,3,0,0,0,0,54
1138317,45,0,0,0,0,0,0,45
1138318,30,0,0,4,0,0,0,34
1138319,48,5,0,0,0,0,0,53
1138320,74,4,0,0,0,0,0,78
1138321,38,4,0,0,0,0,0,42
1138322,65,4,0,0,0,0,0,69
1138323,52,4,3,0,0,0,0,59
1138324,66,3,0,3,0,0,0,72
1138325,65,0,0,3,0,0,0,68
1138326,86,3,3,3,0,0,0,95
1138327,58,3,3,0,0,0,0,64
1138328,50,9,0,0,0,0,0,59
1138329,60,3,0,3,0,0,3,69
1138330,66,4,0,0,0,0,0,70
1138331,70,3,0,0,0,0,0,73
1138332,0,0,0,0,0,0,0,0
1138333,35,3,3,0,0,0,0,41
1138334,66,3,0,3,0,0,0,72
1138335,58,5,4,0,0,0,0,67
1138336,0,0,0,0,0,0,0,0
1138337,80,0,3,3,0,0,0,86
1138338,70,3,0,3,0,0,0,76
1138339,39,5,4,0,0,0,0,48
1138340,94,3,3,0,0,0,0,100
1138341,71,3,0,0,0,0,0,74
1138342,30,3,0,3,0,0,0,36
1138343,28,0,0,0,0,0,0,28
1138344,87,12,0,0,0,0,0,99
1138345,44,0,3,0,0,0,0,47
1138346,0,0,0,0,0,0,0,0
1138347,69,3,3,0,0,0,0,75
1138348,73,0,3,0,0,0,0,76
1138349,51,3,0,0,0,0,0,54
1138401,43,0,0,0,0,0,0,43
1138402,62,4,0,0,0,0,0,66
1138403,48,0,0,0,0,0,0,48
1138404,29,0,0,0,0,0,0,29
1138405,0,0,0,0,0,0,0,0
1138406,44,3,0,3,0,0,0,50
1138407,75,4,3,0,0,0,0,82
1138408,63,7,3,0,0,0,0,73
1138409,37,0,3,0,0,0,0,40
1138410,50,3,0,0,0,0,0,53
1138411,48,3,0,3,0,0,0,54
1138412,3,0,0,0,0,0,0,3
1138413,0,0,0,0,0,0,0,0
1138414,0,0,0,0,0,0,0,0
1138415,43,3,0,0,0,0,0,46
1138416,230,10,5,0,0,0,0,245
1138417,47,0,0,0,0,0,0,47
1138418,62,3,0,3,0,3,0,71
1138419,83,3,0,0,0,0,0,86
1138420,51,0,3,3,0,0,0,57
1138421,44,0,0,3,0,0,0,47
1138422,28,0,0,0,0,0,0,28
1138423,60,4,0,4,0,0,0,68
1138424,105,0,0,0,0,0,0,105
1138425,68,3,0,0,0,0,0,71
1138426,0,0,0,0,0,0,0,0
1138427,72,3,0,0,0,0,0,75
1138428,59,4,0,0,0,0,0,63
1138429,58,0,0,0,0,0,0,58
1138430,47,6,0,0,0,0,4,57
1138431,51,0,0,0,0,0,0,51
1138432,0,0,0,0,0,0,0,0
1138433,74,0,0,0,0,0,0,74
1138434,66,5,0,0,0,0,0,71
1138435,83,3,0,0,0,0,0,86
1138436,71,0,0,3,0,0,3,77
1138437,38,0,0,0,0,0,0,38
1138438,51,3,0,0,0,0,0,54
1138439,50,3,0,0,0,0,0,53
1138440,0,0,0,0,0,0,0,0
1138501,26,0,0,0,0,0,0,26
1138502,26,9,0,0,0,0,0,35
1138503,21,3,3,0,0,0,0,27
1138504,27,3,0,0,0,0,0,30
1138505,30,0,0,0,0,0,0,30
1138506,22,7,0,0,0,0,0,29
1138507,46,3,0,3,0,0,0,52
1138508,50,0,0,0,0,0,4,54
1138509,40,3,0,0,0,0,0,43
1138510,19,3,0,0,0,0,0,22
1138511,43,3,3,0,0,0,0,49
1138512,72,3,0,0,0,0,0,75
1138513,50,3,0,0,0,0,0,53
1138514,44,3,4,0,0,0,0,51
1138515,40,0,0,0,0,0,0,40
1138516,46,6,0,0,0,0,0,52
1138517,53,0,0,0,0,0,0,53
1138518,41,5,0,0,0,0,0,46
1138519,29,0,3,0,0,0,0,32
1138520,64,0,0,0,0,0,0,64
1138521,55,0,0,0,0,0,0,55
1138522,40,0,5,0,0,0,0,45
1138523,40,3,3,0,0,0,0,46
1138524,38,0,4,0,0,0,0,42
1138525,56,4,0,0,0,0,0,60
1138526,54,3,0,0,0,0,0,57
1138527,70,0,3,0,0,0,0,73
1138528,43,3,0,0,0,0,0,46
1138529,28,0,0,3,0,0,0,31
1138530,50,3,0,0,0,0,0,53
1138531,60,8,3,3,0,0,0,74
1138532,56,3,3,0,0,0,0,62
1138533,35,3,0,0,0,0,0,38
1138534,54,4,3,3,0,0,0,64
1138535,50,4,3,0,0,0,0,57
1138536,43,0,0,0,0,0,0,43
1138537,35,4,0,0,0,0,0,39
1138538,77,3,3,0,0,0,0,83
1138539,37,0,0,0,0,0,0,37
1138540,79,7,0,0,0,0,0,86
1138541,55,0,0,0,0,0,0,55
1138542,29,3,0,0,0,0,0,32
1138543,79,3,3,0,0,0,0,85
1138601,30,4,0,0,0,0,0,34
1138602,47,3,3,0,0,0,0,53
1138603,40,7,0,0,0,0,0,47
1138604,64,4,0,0,0,0,0,68
1138605,33,0,3,0,0,0,0,36
1138606,56,4,0,0,0,0,0,60
1138607,38,3,3,0,0,0,0,44
1138608,21,0,0,0,0,0,0,21
1138609,24,0,0,0,0,0,0,24
1138610,47,0,0,0,0,0,0,47
1138611,50,3,0,0,0,0,0,53
1138612,0,0,0,0,0,0,0,0
1138613,55,4,0,0,0,0,0,59
1138614,37,3,0,0,0,0,0,40
1138615,65,3,0,0,0,0,0,68
1138616,54,0,0,4,0,0,0,58
1138617,39,3,0,0,0,0,0,42
1138618,46,3,0,0,0,0,0,49
1138619,0,0,0,0,0,0,0,0
1138620,66,0,0,0,0,0,0,66
1138621,34,3,0,0,0,0,0,37
1138622,50,5,0,0,0,0,0,55
1138623,47,9,0,0,0,0,0,56
1138624,44,0,0,0,0,0,0,44
1138625,37,4,0,0,0,0,0,41
1138626,48,0,0,0,0,0,0,48
1138627,22,0,4,0,0,0,0,26
1138628,48,4,0,0,0,0,0,52
1138629,49,3,3,0,0,0,0,55
1138630,32,0,0,0,0,0,0,32
1138631,0,0,0,0,0,0,0,0
1138632,55,5,3,0,0,0,0,63
1138633,38,0,5,0,0,0,0,43
1138634,70,3,0,0,0,0,0,73
1138635,45,3,0,0,0,0,0,48
1138636,84,5,0,0,0,0,0,89
1138637,55,5,0,0,0,0,3,63
1138638,39,3,0,0,0,0,0,42
1138639,29,3,3,0,0,0,0,35
1138640,65,6,4,0,0,0,0,75
1138641,30,4,0,0,0,0,0,34
1138642,49,0,4,0,0,0,0,53
1138643,32,3,0,0,0,0,0,35
1138644,63,0,0,0,0,0,0,63
1138645,47,0,0,0,0,0,0,47
1138646,51,3,0,0,0,0,0,54
1138647,36,0,3,0,0,0,0,39
1138648,51,3,3,0,0,0,0,57
1138649,56,0,3,3,0,0,0,62
1138650,55,0,0,3,0,0,0,58
1138701,48,0,0,0,0,0,0,48
1138702,19,0,0,0,0,0,0,19
1138703,22,0,0,0,0,0,0,22
1138704,45,0,3,0,0,0,0,48
1138705,20,3,0,0,0,0,0,23
1138706,67,3,0,0,0,0,0,70
1138707,31,0,0,0,0,0,0,31
1138708,62,7,0,0,0,0,0,69
1138709,58,3,0,0,0,0,0,61
1138710,50,7,0,0,0,0,0,57
1138711,24,0,0,0,0,0,0,24
1138712,32,3,0,3,0,0,0,38
1138713,22,3,0,0,0,0,0,25
1138714,39,3,3,0,0,0,0,45
1138715,44,0,0,0,0,0,0,44
1138716,36,3,0,0,0,0,0,39
1138717,36,0,0,0,0,0,0,36
1138718,47,3,3,0,0,0,0,53
1138719,26,0,0,0,0,0,0,26
1138720,45,0,0,0,0,0,0,45
1138721,52,4,4,0,0,0,0,60
1138722,35,0,0,0,0,0,0,35
1138723,28,0,0,0,0,0,0,28
1138724,0,0,0,0,0,0,0,0
1138725,25,0,0,0,0,0,0,25
1138726,41,0,0,0,0,0,0,41
1138727,27,0,0,0,0,0,0,27
1138728,35,0,4,0,0,0,0,39
1138729,46,3,0,0,0,0,0,49
1138730,0,0,0,0,0,0,0,0
1138731,61,3,0,0,0,0,0,64
1138732,30,3,0,0,0,0,0,33
1138733,24,0,0,0,0,0,0,24
1138734,46,3,0,0,0,0,0,49
1138735,15,3,0,0,0,0,0,18
1138736,53,8,3,0,0,0,0,64
1138737,34,0,0,0,0,0,0,34
1138738,0,0,0,0,0,0,0,0
1138739,29,6,0,0,0,0,0,35
1138740,19,3,0,0,0,0,0,22
1138741,19,3,0,0,0,0,0,22
1138742,42,0,0,0,0,0,0,42
1138801,48,0,3,0,0,0,0,51
1138802,57,0,3,0,0,0,3,63
1138803,22,3,0,0,0,0,0,25
1138804,29,0,0,0,0,0,0,29
1138805,53,5,3,0,0,0,0,61
1138806,35,0,3,0,0,0,3,41
1138807,39,3,3,0,0,0,0,45
1138808,56,3,3,0,0,0,0,62
1138809,42,3,0,0,0,0,0,45
1138810,42,3,3,3,0,0,0,51
1138811,22,0,0,0,0,0,0,22
1138812,44,4,0,0,0,0,0,48
1138813,37,0,0,0,0,0,0,37
1138814,22,0,0,0,0,0,0,22
1138815,21,3,5,0,0,0,0,29
1138816,35,0,0,0,0,0,0,35
1138817,56,4,0,0,0,0,0,60
1138818,35,3,0,0,0,0,0,38
1138819,62,3,0,0,0,0,0,65
1138820,42,3,0,3,0,0,0,48
1138821,31,0,3,0,0,0,0,34
1138822,45,3,0,0,0,0,0,48
1138823,44,3,0,0,0,0,0,47
1138824,41,4,0,0,0,0,0,45
1138825,35,3,0,0,0,0,0,38
1138826,36,3,0,0,0,0,0,39
1138827,63,5,0,0,0,0,0,68
1138828,64,0,3,0,0,0,0,67
1138829,59,0,0,0,0,0,0,59
1138830,49,4,0,0,0,0,0,53
1138831,57,4,0,0,0,0,0,61
1138832,48,3,0,0,0,0,0,51
1138833,47,8,0,0,0,0,0,55
1138834,43,0,3,0,0,0,0,46
1138835,46,6,0,0,0,0,0,52
1138836,36,4,0,0,0,0,0,40
1138837,45,10,0,0,0,0,0,55
1138838,61,3,0,0,0,0,0,64
1138839,33,3,0,0,0,0,0,36
1138840,39,3,3,0,0,0,0,45
1138841,41,4,0,0,0,0,0,45
1138842,96,0,4,4,0,0,0,104
1138843,57,0,0,0,0,0,0,57
1138844,35,0,0,0,0,0,0,35
1138845,48,0,0,0,0,0,3,51
1138846,60,0,0,0,0,0,0,60
1138847,27,8,0,0,0,0,0,35
1138848,51,4,0,0,0,0,0,55
1138849,62,0,0,0,0,0,0,62
1138850,23,4,0,0,0,0,0,27
1138851,38,4,3,0,0,0,0,45
1138852,52,3,3,0,0,0,0,58
1138853,47,4,0,0,0,0,3,54
1138854,56,6,0,0,0,0,0,62
1138855,26,0,0,0,0,0,0,26
1138901,0,0,0,0,0,0,0,0
1138902,71,3,3,0,0,0,0,77
1138903,77,3,0,0,0,3,0,83
1138904,64,8,4,0,0,0,4,80
1138905,0,0,0,0,0,0,0,0
1138906,61,4,0,0,0,0,0,65
1138907,45,0,0,0,0,0,0,45
1138908,51,3,0,0,0,0,0,54
1138909,0,0,0,0,0,0,0,0
1138910,0,0,0,0,0,0,0,0
1138911,68,0,0,0,0,0,0,68
1138912,60,4,5,0,0,0,0,69
1138913,57,4,0,0,0,0,0,61
1138914,23,8,0,0,0,0,0,31
1138915,56,6,0,0,0,0,0,62
1138916,78,11,3,0,0,0,0,92
1138917,69,9,0,0,0,0,0,78
1138918,68,8,3,0,0,0,0,79
1138919,67,4,0,0,0,0,0,71
1138920,37,0,0,0,0,0,0,37
1138921,62,8,0,0,0,0,0,70
1138922,41,3,0,0,0,0,0,44
1138923,20,4,0,0,0,0,0,24
1138924,37,4,3,0,0,0,0,44
1138925,39,0,0,0,0,0,0,39
1138926,36,0,3,0,0,0,0,39
1138927,41,3,0,3,0,0,0,47
1138928,22,3,0,0,0,0,0,25
1138929,37,4,3,0,0,0,0,44
1138930,51,0,0,0,0,0,0,51
1139001,52,3,3,3,0,0,0,61
1139002,53,7,3,0,0,0,0,63
1139003,29,3,0,0,0,0,0,32
1139004,28,3,0,0,0,0,0,31
1139005,82,5,0,0,0,0,0,87
1139006,11,3,0,0,0,0,0,14
1139007,45,6,0,0,0,0,0,51
1139008,54,3,3,0,0,0,0,60
1139009,41,4,0,0,0,0,0,45
1139010,45,0,0,0,0,0,0,45
1139011,38,3,0,0,0,0,0,41
1139012,46,0,4,0,0,0,0,50
1139013,41,3,0,0,0,0,0,44
1139014,28,0,3,0,0,0,0,31
1139015,17,0,0,0,0,0,0,17
1139016,45,3,3,0,0,0,0,51
1139017,45,6,0,0,0,0,0,51
1139018,43,4,0,3,0,0,0,50
1139019,31,0,4,4,0,0,0,39
1139020,27,3,0,0,0,0,0,30
1139021,36,3,0,0,0,0,3,42
1139022,26,3,3,0,0,0,0,32
1139023,25,4,0,0,0,0,0,29
1139024,29,0,3,0,0,0,0,32
1139025,44,0,0,0,0,0,0,44
1139026,54,4,0,0,0,0,0,58
1139027,49,3,0,0,0,0,3,55
1139028,36,7,0,0,0,0,0,43
1139029,74,3,3,0,0,0,0,80
1139030,43,0,0,0,0,0,0,43
1139031,73,3,0,3,0,0,0,79
1139032,63,5,0,0,0,0,0,68
1139033,26,3,3,0,0,0,0,32
1139034,36,0,0,3,0,0,0,39
1139035,40,0,0,0,0,0,0,40
1139036,56,3,0,0,0,0,3,62
1139037,59,3,3,0,0,0,0,65
1139038,42,0,0,0,0,0,0,42
1139039,38,0,3,3,0,0,0,44
1139040,29,3,0,3,0,0,0,35
1139041,26,3,0,3,0,0,0,32
1139042,45,0,0,0,0,0,0,45
1139043,38,4,0,0,0,0,0,42
1139044,42,0,0,0,0,0,0,42
1139045,47,0,0,0,0,0,0,47
1139046,26,0,0,0,0,0,0,26
1139047,24,0,0,0,0,0,0,24
1139048,31,0,0,0,0,0,0,31
1139049,35,0,0,0,0,0,0,35
1139050,15,3,3,0,0,0,0,21
1139051,35,3,0,0,0,0,3,41
1139052,24,4,0,0,0,0,0,28
1139053,30,0,0,0,0,0,0,30
1139101,28,3,0,3,0,0,0,34
1139102,44,3,0,0,0,0,0,47
1139103,40,4,0,0,0,0,0,44
1139104,47,3,3,0,0,0,0,53
1139105,53,4,3,0,0,0,0,60
1139106,37,8,0,0,0,0,0,45
1139107,45,3,0,0,0,0,0,48
1139108,25,0,3,0,0,3,0,31
1139109,9,0,3,0,0,0,0,12
1139110,63,3,0,3,0,0,0,69
1139111,51,7,3,0,0,0,0,61
1139112,49,0,0,0,0,0,0,49
1139113,58,7,0,0,0,0,0,65
1139114,57,0,0,0,0,0,0,57
1139115,66,3,3,0,0,0,0,72
1139116,45,3,3,3,0,0,0,54
1139117,25,0,0,3,0,0,0,28
1139118,53,0,3,0,0,0,0,56
1139119,28,0,0,3,0,0,0,31
1139120,61,3,3,0,0,0,0,67
1139121,44,3,3,0,0,0,0,50
1139122,40,3,3,0,0,0,0,46
1139123,80,0,0,3,0,0,0,83
1139124,33,0,3,0,0,0,0,36
1139125,33,0,0,4,0,0,0,37
1139126,70,0,0,0,0,0,4,74
1139127,64,7,0,4,0,0,0,75
1139128,72,0,0,0,0,0,0,72
1139129,50,4,0,0,0,0,0,54
1139130,12,3,0,0,0,0,0,15
1139131,81,4,3,0,0,0,0,88
1139132,24,3,0,4,0,0,0,31
1139133,26,0,3,0,3,0,0,32
1139134,51,5,0,0,0,0,0,56
1139135,54,0,3,0,0,0,0,57
1139136,12,0,0,0,0,0,0,12
1139137,35,3,3,0,0,0,0,41
1139138,51,3,3,0,0,0,0,57
1139139,75,0,0,0,0,0,0,75
1139140,41,7,3,0,0,0,0,51
1139141,60,6,0,0,0,0,0,66
1139142,47,0,0,0,0,0,0,47
1139143,45,0,3,0,0,0,0,48
1139144,68,5,0,5,0,0,0,78
1139145,66,3,0,0,0,0,0,69
1139146,54,4,0,0,0,0,0,58
1139147,53,8,0,0,0,0,0,61
1139148,11,0,0,0,0,0,0,11
1139149,29,0,0,0,0,0,0,29
1139201,41,5,0,0,0,0,0,46
1139202,41,4,0,0,0,0,0,45
1139203,25,3,3,0,0,0,0,31
1139204,70,0,3,0,0,0,0,73
1139205,63,3,0,0,0,0,0,66
1139206,55,3,0,0,0,0,0,58
1139207,83,5,7,0,0,0,0,95
1139208,37,3,0,0,0,0,0,40
1139209,3,0,0,0,0,0,0,3
1139210,21,3,0,0,0,0,0,24
1139211,47,3,3,0,0,0,0,53
1139212,43,3,3,0,0,0,0,49
1139213,44,0,0,0,0,0,0,44
1139214,34,3,0,0,3,0,0,40
1139215,67,3,0,0,0,0,0,70
1139216,60,3,0,3,0,0,0,66
1139217,38,0,3,0,0,0,0,41
1139218,36,0,0,0,0,0,0,36
1139219,74,3,0,0,0,0,0,77
1139220,40,0,0,0,0,0,3,43
1139221,67,3,0,0,0,0,0,70
1139222,51,3,0,0,0,0,0,54
1139223,47,0,0,0,0,0,0,47
1139224,43,3,0,3,0,0,0,49
1139225,43,0,0,0,0,0,0,43
1139226,34,3,3,0,0,0,0,40
1139301,71,3,0,3,0,0,0,77
1139302,56,3,0,3,0,0,0,62
1139303,61,7,0,6,0,0,0,74
1139304,33,3,3,0,0,0,0,39
1139305,56,3,0,0,0,0,0,59
1139306,23,0,0,0,0,0,0,23
1139307,28,0,0,0,0,0,0,28
1139308,31,0,0,0,0,0,0,31
1139309,47,0,0,0,0,0,0,47
1139310,15,0,0,0,0,0,0,15
1139311,55,0,0,0,0,0,0,55
1139312,32,7,3,0,0,0,0,42
1139313,63,5,3,3,0,0,0,74
1139314,77,3,3,3,0,0,0,86
1139315,48,5,0,0,0,0,0,53
1139316,70,4,0,0,0,0,0,74
1139317,78,3,4,3,0,0,0,88
1139318,41,3,3,0,0,0,0,47
1139319,69,3,0,5,0,0,0,77
1139320,64,3,0,0,0,0,0,67
1139321,79,6,3,0,0,0,0,88
1139322,36,0,0,0,0,0,0,36
1139323,47,0,0,0,0,0,0,47
1139324,32,0,4,0,0,0,0,36
1139325,36,0,0,0,0,0,3,39
1139326,79,0,4,0,0,0,0,83
1139327,51,0,3,0,0,0,0,54
1139328,54,3,0,0,0,0,0,57
1139329,46,3,0,0,0,0,0,49
1139330,58,7,0,0,0,0,0,65
1139331,62,0,3,0,0,0,0,65
1139332,51,3,3,0,0,0,0,57
1139333,46,0,0,0,0,0,0,46
1139334,66,0,0,0,0,0,0,66
1139335,36,8,4,0,0,0,0,48
1139336,59,0,0,5,0,0,0,64
1139337,36,0,3,0,0,0,0,39
1139338,77,3,3,0,0,0,0,83
1139339,41,3,0,0,0,0,0,44
1139340,42,0,0,0,0,0,0,42
1139401,60,8,3,0,0,0,0,71
1139402,18,0,0,0,0,0,0,18
1139403,39,3,0,3,0,0,0,45
1139404,55,0,5,0,0,0,0,60
1139405,47,0,0,0,0,0,0,47
1139406,37,0,3,0,0,0,0,40
1139407,59,3,0,0,0,0,0,62
1139408,31,0,0,5,0,0,0,36
1139409,32,0,0,0,0,0,0,32
1139410,23,3,3,3,0,0,0,32
1139411,45,3,3,0,0,0,0,51
1139412,41,4,6,0,0,0,0,51
1139413,39,0,0,0,0,0,0,39
1139414,45,3,0,3,0,0,3,54
1139415,40,3,0,0,0,0,0,43
1139416,34,0,0,0,0,0,0,34
1139417,46,0,0,0,0,0,0,46
1139418,64,3,3,0,0,0,0,70
1139419,30,0,5,0,0,0,0,35
1139420,55,3,0,0,0,0,0,58
1139421,33,0,0,0,0,0,0,33
1139422,32,0,0,0,0,0,0,32
1139423,46,0,0,0,0,0,0,46
1139424,39,3,0,0,0,0,0,42
1139425,46,5,0,0,0,0,0,51
1139426,29,3,3,0,0,0,0,35
1139427,20,4,0,0,0,0,0,24
1139428,56,3,0,0,0,0,0,59
1139429,45,0,0,0,0,0,3,48
1139430,48,7,0,0,0,0,0,55
1139431,27,3,0,0,0,0,0,30
1139432,69,0,0,0,0,0,0,69
1139433,38,0,0,0,0,0,0,38
1139434,38,0,3,3,0,0,0,44
1139435,23,5,0,0,0,0,0,28
1139436,25,0,3,0,0,0,0,28
1139437,14,4,0,0,0,0,0,18
1139438,7,0,0,0,0,0,0,7
1139439,34,3,3,0,0,0,0,40
1139501,43,0,0,0,0,0,0,43
1139502,38,0,0,3,0,0,0,41
1139503,73,0,3,0,0,0,0,76
1139504,37,0,0,0,0,0,0,37
1139505,36,0,3,0,0,0,0,39
1139506,83,7,0,0,0,0,0,90
1139507,65,0,0,0,0,0,0,65
1139508,48,0,0,0,0,0,0,48
1139509,23,4,0,0,0,0,0,27
1139510,20,0,0,0,0,0,0,20
1139511,17,3,0,0,0,0,0,20
1139512,21,0,0,0,0,0,0,21
1139513,29,0,0,0,0,0,0,29
1139514,21,3,3,0,0,0,0,27
1139515,62,3,0,0,0,0,0,65
1139516,46,3,0,0,0,0,0,49
1139517,46,3,0,0,0,0,0,49
1139518,68,3,0,0,0,0,3,74
1139519,36,3,0,3,0,0,0,42
1139520,45,0,0,0,0,0,0,45
1139521,49,6,0,0,0,0,0,55
1139522,51,0,0,0,0,0,0,51
1139523,54,4,0,0,0,0,0,58
1139524,56,3,0,0,0,0,0,59
1139525,45,0,0,0,0,0,0,45
1139526,47,0,0,0,0,0,0,47
1139527,55,0,0,0,0,0,0,55
1139528,49,3,0,0,0,0,0,52
1139529,53,3,3,0,0,0,0,59
1139530,70,0,0,0,0,0,0,70
1139531,52,3,0,4,0,0,0,59
1139532,81,0,4,0,0,0,0,85
1139601,87,5,0,0,0,0,0,92
1139602,62,3,0,0,0,0,0,65
1139603,36,0,0,0,0,0,0,36
1139604,74,5,0,3,0,0,0,82
1139605,30,0,0,0,0,0,0,30
1139606,59,4,0,4,0,0,0,67
1139607,42,0,0,0,0,0,0,42
1139608,67,0,0,6,0,0,0,73
1139609,19,0,3,3,0,0,0,25
1139610,69,4,0,0,0,0,0,73
1139611,35,0,0,0,0,0,0,35
1139612,23,0,0,3,0,0,0,26
1139613,57,0,3,0,0,0,0,60
1139614,49,0,0,0,0,0,0,49
1139615,72,5,0,3,0,0,0,80
1139616,66,3,0,0,0,0,0,69
1139617,64,0,4,0,0,0,0,68
1139618,54,3,5,0,0,0,0,62
1139619,42,4,0,0,0,0,0,46
1139620,65,3,0,0,0,0,0,68
1139621,3,0,0,0,0,0,0,3
1139622,3,0,0,0,0,0,0,3
1139623,0,0,0,0,0,0,0,0
1139624,76,3,3,3,0,0,0,85
1139625,75,0,0,0,0,0,0,75
1139626,91,3,0,3,0,0,3,100
1139627,0,0,0,0,0,0,0,0
1139628,31,3,0,3,0,0,0,37
1139629,70,4,0,5,0,0,0,79
1139701,41,3,0,0,0,0,0,44
1139702,30,3,0,3,0,0,0,36
1139703,0,0,0,0,0,0,0,0
1139704,0,0,0,0,0,0,0,0
1139705,29,0,0,0,0,0,0,29
1139706,91,3,3,4,0,0,0,101
1139707,74,3,3,0,0,0,0,80
1139708,90,5,0,0,0,0,0,95
1139709,51,4,3,0,0,0,0,58
1139710,45,4,0,0,0,0,3,52
1139711,48,6,3,0,0,0,0,57
1139712,52,7,3,0,0,0,0,62
1139713,42,0,0,0,0,0,0,42
1139714,26,3,0,0,0,0,0,29
1139715,62,0,0,0,0,0,0,62
1139716,27,0,0,0,0,0,0,27
1139717,40,3,0,0,0,0,3,46
1139718,51,0,5,3,0,0,0,59
1139719,23,0,0,0,0,0,0,23
1139720,53,3,0,0,0,0,0,56
1139721,17,0,0,0,0,0,3,20
1139722,64,0,0,0,0,0,0,64
1139723,89,3,3,0,0,0,0,95
1139724,63,0,0,0,0,0,0,63
1139725,73,0,0,0,0,0,0,73
1139726,51,3,0,0,0,0,0,54
1139727,47,3,0,0,0,0,0,50
1139728,4,0,0,0,0,0,0,4
1139729,63,3,0,0,0,0,0,66
1139730,65,3,0,0,0,0,0,68
1139731,25,3,0,0,0,0,0,28
1139732,7,0,3,0,0,0,0,10
1139733,49,0,0,0,0,0,0,49
1139734,88,0,0,0,0,0,0,88
1139735,71,3,0,0,0,0,0,74
1139736,57,0,0,0,0,0,0,57
1139737,64,0,0,0,0,0,0,64
1139738,49,3,0,0,0,0,0,52
1139739,63,0,0,0,0,0,0,63
1139740,65,0,4,0,0,0,0,69
1139741,38,3,0,3,0,0,0,44
1139742,27,0,0,0,0,0,0,27
1139743,46,0,0,0,0,0,0,46
1139744,56,0,0,0,0,0,0,56
1139745,24,0,0,0,0,0,0,24
1139746,45,4,0,0,0,0,0,49
1139747,37,0,0,0,0,0,0,37
1139748,53,0,0,0,0,0,4,57
1139749,38,4,0,0,0,0,0,42
1139750,63,0,0,3,0,0,0,66
1139751,76,3,3,0,0,0,0,82
1139752,63,3,0,3,0,0,0,69
1139753,0,0,0,0,0,0,0,0
1139754,76,0,0,0,0,0,0,76
1139755,52,3,3,3,0,0,0,61
1139756,64,0,0,0,0,0,0,64
1139757,76,0,3,0,0,0,0,79
1139758,82,3,0,3,0,0,0,88
1139759,74,3,0,3,0,0,0,80
1139760,49,0,0,0,0,0,0,49
1139761,49,0,0,0,0,0,0,49
1139801,0,0,0,0,0,0,0,0
1139802,24,4,0,0,0,0,0,28
1139803,40,0,0,0,0,0,0,40
1139804,39,0,0,0,0,0,0,39
1139805,64,4,0,0,0,0,0,68
1139806,63,0,0,0,0,0,0,63
1139807,57,3,0,3,0,0,3,66
1139808,32,0,0,0,0,0,0,32
1139809,46,0,0,0,0,0,0,46
1139810,25,0,0,3,0,0,0,28
1139811,75,0,0,0,0,0,0,75
1139812,71,0,0,5,0,0,0,76
1139813,36,6,0,0,0,0,0,42
1139814,49,5,0,0,0,0,3,57
1139815,49,3,0,0,0,0,0,52
1139816,53,0,0,5,0,0,0,58
1139817,22,0,0,0,0,0,0,22
1139818,8,3,0,0,0,0,0,11
1139819,28,3,3,0,0,0,0,34
1139820,32,4,0,0,0,0,0,36
1139821,26,3,0,0,0,0,0,29
1139822,94,4,0,0,0,0,0,98
1139823,47,0,0,0,0,0,0,47
1139824,59,4,0,3,0,0,0,66
1139825,55,4,0,0,0,0,0,59
1139826,46,4,0,0,0,0,0,50
1139827,80,4,0,0,0,0,0,84
1139828,41,0,0,0,0,0,0,41
1139829,40,0,0,3,0,0,0,43
1139830,98,5,0,4,0,0,0,107
1139831,42,0,0,0,0,0,0,42
1139832,49,7,0,0,0,0,0,56
1139833,38,0,0,3,0,0,0,41
1139834,25,3,0,0,0,0,0,28
1139835,29,0,0,0,0,0,0,29
1139836,82,3,0,0,0,0,0,85
1139837,54,3,0,0,0,0,3,60
1139838,62,0,0,0,0,0,0,62
1139839,40,0,0,3,0,0,0,43
1139840,52,0,0,0,0,0,0,52
1139841,26,0,5,0,0,0,0,31
1139842,20,0,0,0,0,0,0,20
1139843,41,6,0,0,0,0,0,47
1139844,83,4,0,0,0,0,0,87
1139845,50,3,0,0,0,0,0,53
1139846,62,0,0,0,0,0,0,62
1139847,49,0,0,0,0,0,0,49
1139848,49,3,0,0,0,0,3,55
1139849,90,9,3,0,0,0,0,102
1139850,25,0,0,0,0,0,0,25
1139851,48,0,0,0,0,0,0,48
1139852,42,0,0,0,0,0,0,42
1139853,63,0,3,0,0,0,0,66
1139854,26,0,0,0,0,0,0,26
1139855,82,0,0,7,0,0,0,89
1139856,31,0,0,0,0,0,0,31
1139857,27,4,0,0,0,0,0,31
1139858,47,3,0,0,0,0,0,50
1139859,32,0,0,0,0,0,0,32
1139901,46,0,0,3,0,0,3,52
1139902,59,0,3,0,0,0,0,62
1139903,29,4,3,0,0,0,0,36
1139904,34,0,0,0,0,0,0,34
1139905,42,3,0,0,0,0,0,45
1139906,40,0,0,0,0,0,0,40
1139907,67,10,4,0,0,0,0,81
1139908,47,7,0,0,0,0,0,54
1139909,73,0,0,0,0,0,0,73
1139910,34,3,0,0,0,0,0,37
1139911,41,0,0,0,0,0,0,41
1139912,38,5,0,0,0,0,0,43
1139913,44,4,0,0,0,0,0,48
1139914,47,0,0,0,0,0,0,47
1139915,40,0,3,0,0,0,0,43
1139916,56,5,0,0,0,0,0,61
1139917,70,4,0,3,0,0,0,77
1139918,54,0,0,0,0,0,0,54
1139919,87,3,3,0,0,0,0,93
1139920,66,3,3,0,0,0,0,72
1139921,64,4,3,0,0,0,0,71
1139922,67,4,0,0,0,0,0,71
1139923,90,3,3,0,0,0,0,96
1139924,43,4,0,0,0,0,0,47
1139925,39,4,0,0,0,0,0,43
1139926,22,3,3,0,0,0,0,28
1139927,47,3,0,0,0,0,3,53
1139928,30,3,0,0,0,0,0,33
1139929,44,3,0,3,0,0,0,50
1139930,68,0,0,0,0,0,0,68
1139931,79,4,0,0,0,0,0,83
1139932,63,0,0,0,0,0,0,63
1139933,43,3,0,0,0,0,0,46
1139934,66,3,0,0,0,0,0,69
1139935,36,0,0,0,0,0,0,36
1139936,55,0,0,0,0,0,0,55
1139937,48,0,0,0,0,0,0,48
1139938,54,4,0,0,0,0,0,58
1139939,39,0,0,0,0,0,0,39
1139940,45,0,0,0,0,0,0,45
1139941,70,3,0,0,0,0,0,73
1139942,30,0,0,0,0,0,0,30
1140001,48,0,0,0,0,0,0,48
1140002,40,3,3,0,0,0,0,46
1140003,0,0,0,0,0,0,0,0
1140004,35,0,0,0,0,0,0,35
1140005,45,4,0,0,0,0,0,49
1140006,68,3,0,0,0,0,0,71
1140007,62,3,0,0,0,0,0,65
1140008,51,5,0,0,0,0,0,56
1140009,84,4,3,0,0,0,0,91
1140010,45,3,3,0,0,0,0,51
1140011,79,3,3,0,0,0,0,85
1140012,80,0,3,0,0,0,0,83
1140013,3,0,0,0,0,0,0,3
1140014,41,0,0,7,0,0,0,48
1140015,83,3,3,0,0,0,0,89
1140016,83,3,3,0,0,0,0,89
1140017,52,5,3,0,0,0,0,60
1140018,66,3,0,0,0,0,0,69
1140019,38,5,0,0,0,0,0,43
1140020,102,3,0,0,0,0,0,105
1140021,31,5,4,0,0,0,0,40
1140022,23,3,0,0,0,0,0,26
1140023,75,3,0,0,0,0,0,78
1140024,30,3,0,0,0,0,0,33
1140025,78,3,3,0,0,0,0,84
1140026,59,7,0,0,0,0,0,66
1140027,79,3,0,0,0,0,0,82
1140028,55,0,0,0,0,0,0,55
1140029,92,3,0,0,0,0,0,95
1140030,68,4,0,0,0,0,0,72
1140031,50,0,0,0,0,0,0,50
1140032,40,0,3,0,0,0,0,43
1140033,39,0,0,0,0,0,0,39
1140034,63,4,0,0,0,0,0,67
1140035,57,4,3,0,0,0,0,64
1140036,47,4,0,0,0,0,0,51
1140037,49,3,0,0,0,0,0,52
1140038,48,0,0,0,0,0,0,48
1140039,58,6,4,0,0,0,0,68
1140040,65,4,0,0,0,0,0,69
1140041,67,3,3,0,0,0,0,73
1140042,33,3,0,0,0,0,0,36
1140043,76,3,0,0,3,0,0,82
1140044,40,3,3,0,0,0,0,46
1140045,37,0,0,0,0,0,0,37
1140046,53,3,3,0,0,0,0,59
1140047,65,6,3,0,0,0,0,74
1140048,71,3,0,0,0,0,0,74
1140049,31,3,0,0,0,0,0,34
1140050,75,3,0,0,0,0,0,78
1140051,64,5,0,0,0,0,0,69
1140052,45,6,0,3,0,0,0,54
1140053,74,5,3,0,0,0,0,82
1140054,59,7,3,0,0,0,0,69
1140055,63,7,0,0,0,0,0,70
1140056,59,4,0,0,0,0,0,63
1140101,56,7,3,3,0,0,0,69
1140102,91,4,0,0,0,0,0,95
1140103,73,4,0,0,0,0,0,77
1140104,45,0,0,0,0,0,0,45
1140105,0,0,0,0,0,0,0,0
1140106,0,0,0,0,0,0,0,0
1140107,0,0,0,0,0,0,0,0
1140108,0,0,0,0,0,0,0,0
1140109,25,0,0,0,0,0,0,25
1140110,26,3,0,0,0,0,0,29
1140111,92,5,3,0,0,0,0,100
1140112,34,0,4,0,0,0,0,38
1140113,95,4,0,0,0,0,0,99
1140114,32,3,0,0,0,0,0,35
1140115,44,0,0,0,0,0,0,44
1140116,31,3,0,0,0,0,0,34
1140117,38,0,0,0,0,0,0,38
1140118,76,4,3,0,0,0,0,83
1140119,38,0,0,0,0,0,0,38
1140120,12,0,0,0,0,0,0,12
1140121,54,4,0,0,0,0,0,58
1140122,41,0,0,0,0,0,0,41
1140201,66,3,0,0,0,0,0,69
1140202,72,3,0,0,0,0,0,75
1140203,96,5,0,0,0,0,3,104
1140204,65,4,0,0,0,0,0,69
1140205,83,6,0,0,0,0,0,89
1140206,114,8,0,0,0,0,0,122
1140207,120,4,4,0,0,0,0,128
1140208,55,3,0,0,0,0,0,58
1140209,40,6,0,0,0,0,0,46
1140210,60,4,0,0,0,0,0,64
1140211,94,3,0,0,0,0,0,97
1140212,49,4,0,3,0,0,0,56
1140213,64,4,0,0,0,0,0,68
1140214,69,3,0,0,0,0,0,72
1140215,54,3,3,0,0,0,0,60
1140216,80,3,3,0,0,0,0,86
1140217,44,0,4,0,0,0,0,48
1140218,70,3,0,0,0,0,0,73
1140219,37,3,0,0,0,0,0,40
1140220,50,4,0,0,0,0,0,54
1140221,35,5,0,0,0,0,0,40
1140222,79,3,3,0,0,0,0,85
1140223,46,5,0,0,0,0,0,51
1140224,37,3,0,0,0,0,0,40
1140225,41,3,3,0,0,0,0,47
1140226,47,3,3,0,0,0,0,53
1140227,40,5,3,0,0,0,0,48
1140228,78,4,4,0,0,0,0,86
1140229,71,4,3,0,0,0,0,78
1140230,64,0,0,0,0,0,0,64
1140231,62,4,3,0,0,0,0,69
1140232,0,0,0,0,0,0,0,0
1140233,73,0,0,0,0,0,0,73
1140234,60,3,0,0,0,0,0,63
1140235,39,0,0,0,0,0,0,39
1140236,31,4,0,0,0,0,0,35
1140237,56,4,0,3,0,0,0,63
1140238,75,5,3,3,0,0,0,86
1140239,63,4,0,0,0,0,0,67
1140240,84,4,0,0,0,0,0,88
1140241,93,0,0,0,0,0,3,96
1140242,53,4,0,0,0,0,0,57
1140243,46,0,0,0,0,0,0,46
1140244,46,0,4,0,0,0,0,50
1140245,75,0,6,0,0,0,0,81
1140246,76,3,0,0,0,0,3,82
1140247,63,3,0,0,0,0,0,66
1140248,49,8,0,0,0,0,0,57
1140249,68,0,3,0,0,0,0,71
1140250,86,3,0,0,0,0,0,89
1140251,58,0,5,0,0,0,0,63
1140252,87,0,0,0,0,0,0,87
1140253,56,6,0,0,0,0,0,62
1140254,33,3,0,0,0,0,0,36
1140255,35,0,3,0,0,0,0,38
1140256,51,3,0,0,0,0,0,54
1140257,61,0,0,0,0,0,0,61
1140301,56,4,0,0,0,0,3,63
1140302,67,3,3,0,0,0,0,73
1140303,60,0,3,0,0,0,0,63
1140304,100,5,3,0,0,0,0,108
1140305,38,0,3,0,0,0,0,41
1140306,32,0,0,0,0,0,0,32
1140307,0,0,0,0,0,0,0,0
1140308,44,0,0,0,0,0,0,44
1140309,41,0,0,0,0,0,0,41
1140310,58,3,3,0,0,0,0,64
1140311,89,3,6,0,0,0,0,98
1140312,62,0,0,3,0,0,0,65
1140313,61,3,0,0,0,0,0,64
1140314,79,5,3,0,0,0,0,87
1140315,38,9,0,4,0,0,0,51
1140316,53,3,0,0,0,0,0,56
1140317,62,3,3,0,0,0,0,68
1140318,67,4,3,0,0,0,0,74
1140319,64,5,5,0,0,0,0,74
1140320,40,4,0,0,0,0,0,44
1140321,78,7,3,0,0,0,3,91
1140322,77,3,0,5,0,0,0,85
1140323,60,0,4,0,0,0,0,64
1140324,85,0,3,3,0,0,0,91
1140325,62,4,0,0,0,0,0,66
1140326,46,0,3,0,0,0,0,49
1140327,35,0,0,0,0,0,0,35
1140328,64,3,0,0,0,0,0,67
1140329,72,3,0,0,0,0,0,75
1140330,64,4,3,0,0,0,0,71
1140331,48,3,0,0,0,0,0,51
1140332,82,4,6,0,0,0,0,92
1140333,37,5,3,0,0,0,0,45
1140334,41,0,0,0,0,0,0,41
1140335,0,0,0,0,0,0,0,0
1140336,66,6,0,0,0,0,0,72
1140337,48,5,0,0,0,0,0,53
1140338,83,7,0,0,0,0,0,90
1140339,51,3,3,0,0,0,0,57
1140340,98,5,8,0,0,0,0,111
1140341,72,8,0,3,0,0,0,83
1140342,69,5,0,0,0,0,0,74
1140343,50,0,0,0,0,0,0,50
1140344,0,0,0,0,0,0,0,0
1140345,0,0,0,0,0,0,0,0
1140346,59,3,3,0,0,0,0,65
1140347,0,0,0,0,0,0,0,0
1140348,0,0,0,3,0,0,0,3
1140349,0,0,0,0,0,0,0,0
1140350,81,4,7,0,0,0,0,92
1140401,76,3,4,0,0,0,0,83
1140402,0,0,0,0,0,0,0,0
1140403,39,4,0,0,0,0,0,43
1140404,86,3,0,0,0,0,0,89
1140405,58,0,3,0,0,0,0,61
1140406,23,0,0,0,0,0,0,23
1140407,49,0,0,0,0,0,0,49
1140408,25,0,4,0,0,0,0,29
1140409,80,4,4,0,0,0,0,88
1140410,50,3,0,0,0,0,3,56
1140411,53,3,3,0,0,0,0,59
1140412,85,4,0,0,0,0,0,89
1140413,33,3,0,0,0,0,0,36
1140414,49,7,0,0,0,0,0,56
1140415,77,5,0,0,0,0,0,82
1140416,16,0,0,0,0,0,0,16
1140417,44,4,0,0,0,0,0,48
1140418,49,0,3,0,0,0,0,52
1140419,74,5,3,0,0,0,0,82
1140420,47,4,0,0,0,0,0,51
1140421,72,4,0,0,0,0,0,76
1140422,47,3,0,0,0,0,0,50
1140423,41,4,0,0,0,0,0,45
1140424,59,0,0,0,0,0,0,59
1140425,67,4,3,0,0,0,0,74
1140426,47,0,0,0,0,0,0,47
1140427,91,3,6,0,0,0,0,100
1140428,0,0,0,0,0,0,0,0
1140429,73,3,0,0,0,0,0,76
1140430,69,7,3,0,0,0,0,79
1140431,75,3,4,0,0,0,0,82
1140432,22,4,0,0,0,0,0,26
1140501,36,0,0,0,0,0,0,36
1140502,37,3,0,0,0,0,0,40
1140503,30,0,3,0,0,0,3,36
1140504,49,3,0,0,0,0,0,52
1140505,44,0,3,0,0,0,0,47
1140506,31,0,4,0,0,0,0,35
1140507,109,3,0,0,0,0,0,112
1140508,75,0,0,0,0,0,0,75
1140509,36,4,0,0,0,0,0,40
1140510,22,0,4,0,0,0,0,26
1140511,21,0,3,0,0,0,0,24
1140512,101,6,3,3,0,0,0,113
1140513,47,4,0,0,0,0,0,51
1140514,36,3,0,0,0,0,0,39
1140515,47,3,0,0,0,3,0,53
1140516,48,6,0,0,0,0,0,54
1140517,37,0,3,0,0,0,0,40
1140518,63,0,0,0,0,0,3,66
1140519,94,5,3,0,0,0,0,102
1140520,66,0,3,3,0,0,0,72
1140521,33,0,0,3,0,0,0,36
1140522,53,7,0,0,0,0,0,60
1140523,48,4,0,0,0,0,0,52
1140524,63,0,0,0,0,0,0,63
1140525,0,0,0,0,0,0,0,0
1140526,49,3,0,0,0,0,0,52
1140527,32,4,0,0,0,0,0,36
1140528,34,0,0,0,0,0,0,34
1140529,71,4,0,0,0,0,0,75
1140530,35,3,0,0,0,0,0,38
1140531,0,0,0,0,0,0,0,0
1140532,28,3,4,0,0,0,0,35
1140533,42,0,0,0,0,0,0,42
1140534,67,3,3,0,0,0,0,73
1140535,35,3,0,0,0,0,0,38
1140536,55,8,0,0,0,0,0,63
1140537,59,5,0,0,0,0,0,64
1140538,73,5,0,0,0,0,3,81
1140539,60,7,0,0,0,0,0,67
1140540,48,4,0,0,0,0,0,52
1140541,43,5,0,0,0,0,0,48
1140542,47,3,0,0,0,0,0,50
1140543,75,0,8,0,0,0,0,83
1140544,44,0,0,0,0,0,0,44
1140545,74,6,3,0,0,0,0,83
1140546,52,0,0,0,0,0,0,52
1140547,31,3,3,0,0,0,0,37
1140548,62,4,0,0,0,0,0,66
1140549,62,0,0,0,0,0,0,62
1140550,40,0,0,0,0,0,0,40
1140551,30,3,0,0,0,0,0,33
1140552,54,5,0,0,0,0,0,59
1140553,39,3,3,0,0,0,0,45
1140554,56,7,0,0,0,0,0,63
1140555,55,3,0,0,0,0,0,58
1140556,41,5,3,0,0,0,0,49
1140557,37,4,0,0,0,0,0,41
1140558,52,0,0,0,0,0,0,52
1140559,50,5,3,0,0,0,0,58
1140560,59,4,0,0,0,0,0,63
1140561,11,0,0,0,0,0,0,11
1140562,62,0,0,0,0,0,0,62
1140563,42,4,0,0,0,0,0,46
1140564,56,0,0,0,0,0,0,56
1140565,142,7,0,0,0,0,0,149
1140566,132,8,5,0,0,0,0,145
1140567,67,0,0,0,0,0,0,67
1140568,54,7,0,0,0,0,0,61
1140569,41,4,3,0,0,0,0,48
1140570,19,0,0,0,0,0,0,19
1140571,50,4,0,0,0,0,0,54
1140601,36,3,3,0,0,0,0,42
1140602,41,0,3,0,0,0,3,47
1140603,55,0,3,0,0,0,3,61
1140604,61,0,0,0,3,0,0,64
1140605,41,3,0,0,0,0,0,44
1140606,38,4,0,0,0,0,0,42
1140607,39,0,0,3,0,0,0,42
1140608,89,5,0,4,0,0,0,98
1140609,52,6,0,3,0,0,0,61
1140610,42,0,0,0,0,0,0,42
1140611,80,0,0,0,0,0,0,80
1140612,41,0,3,0,0,0,0,44
1140613,66,0,0,0,0,0,0,66
1140614,40,0,3,0,0,0,0,43
1140615,51,5,0,0,0,0,0,56
1140616,60,0,3,0,0,0,0,63
1140617,0,0,0,0,0,0,0,0
1140618,55,6,0,0,0,0,0,61
1140619,85,9,0,0,0,0,0,94
1140620,58,3,3,0,0,0,3,67
1140621,51,5,0,0,0,0,0,56
1140622,58,3,3,0,0,0,0,64
1140623,66,3,0,0,0,0,4,73
1140624,73,3,0,3,0,0,0,79
1140625,50,5,3,0,0,0,0,58
1140626,45,0,0,0,0,0,0,45
1140627,54,0,0,0,0,0,0,54
1140628,40,3,0,0,0,0,3,46
1140629,66,7,0,0,0,0,0,73
1140630,38,5,3,0,0,0,0,46
1140631,56,0,0,0,0,0,0,56
1140632,0,0,0,0,0,0,0,0
1140633,78,6,3,0,0,0,0,87
1140634,75,7,3,4,0,0,0,89
1140635,67,3,0,0,0,0,0,70
1140636,57,0,5,0,0,0,0,62
1140637,36,4,0,0,0,0,0,40
1140638,45,5,0,3,0,0,0,53
1140639,44,0,0,0,0,0,0,44
1140640,63,3,0,0,0,0,0,66
1140641,89,4,4,0,0,0,0,97
1140642,79,3,4,0,0,0,0,86
1140643,46,3,0,0,0,0,0,49
1140644,72,5,3,0,0,0,0,80
1140645,54,5,0,0,0,0,0,59
1140646,37,3,3,0,0,0,0,43
1140647,21,0,0,0,0,0,0,21
1140648,54,5,0,0,0,0,0,59
1140701,58,4,0,0,0,0,0,62
1140702,63,0,0,0,0,0,0,63
1140703,44,4,0,4,0,0,0,52
1140704,82,3,0,3,0,0,0,88
1140705,43,0,3,3,0,0,0,49
1140706,100,4,0,0,0,0,0,104
1140707,64,0,0,0,0,0,0,64
1140708,90,3,3,0,0,0,0,96
1140709,72,0,0,0,0,0,0,72
1140710,84,3,0,5,0,0,0,92
1140711,58,0,0,0,0,0,0,58
1140712,92,3,0,0,0,0,0,95
1140713,25,0,3,0,0,0,0,28
1140714,22,3,0,0,0,0,0,25
1140715,119,7,0,0,0,0,0,126
1140716,0,0,0,0,0,0,0,0
1140717,98,5,0,0,0,0,0,103
1140718,45,0,0,0,0,0,0,45
1140719,37,0,0,0,0,0,0,37
1140720,0,0,0,0,0,0,0,0
1140721,46,0,0,0,0,0,0,46
1140722,43,0,0,0,0,0,0,43
1140723,75,0,0,0,0,0,0,75
1140724,55,0,0,0,0,0,0,55
1140725,63,0,5,0,0,0,0,68
1140726,53,0,0,0,0,0,0,53
1140727,75,3,0,0,0,0,0,78
1140728,65,3,0,3,0,0,0,71
1140729,59,3,0,3,0,0,0,65
1140730,49,0,0,0,0,0,0,49
1140731,43,4,0,0,0,0,0,47
1140732,79,0,0,0,0,0,0,79
1140733,34,3,0,4,0,0,0,41
1140734,40,4,0,0,0,0,0,44
1140735,58,3,3,0,0,0,0,64
1140736,64,3,3,3,0,0,0,73
1140737,50,3,3,0,0,0,0,56
1140738,29,4,0,0,0,0,0,33
1140739,62,0,3,0,0,0,0,65
1140740,88,5,0,3,0,0,0,96
1140741,64,3,3,5,0,0,0,75
1140742,86,6,3,0,0,0,0,95
1140743,74,0,0,0,0,0,0,74
1140744,26,5,0,0,0,0,0,31
1140745,41,0,0,4,0,0,0,45
1140746,52,0,0,0,0,0,3,55
1140801,55,0,0,0,0,0,0,55
1140802,38,3,0,0,0,0,0,41
1140803,40,0,0,0,0,0,0,40
1140804,75,4,3,0,0,0,0,82
1140805,64,3,0,3,0,0,3,73
1140806,60,3,4,0,0,0,0,67
1140807,87,3,0,0,0,0,0,90
1140808,26,3,3,0,0,0,0,32
1140809,42,7,0,0,0,0,0,49
1140810,69,0,0,0,0,0,0,69
1140811,40,0,0,0,0,0,0,40
1140812,76,3,0,0,0,0,0,79
1140813,71,3,0,0,0,0,0,74
1140814,62,0,0,0,0,0,0,62
1140815,46,4,0,0,0,0,0,50
1140816,37,4,4,0,0,0,0,45
1140817,69,0,0,5,0,0,0,74
1140818,48,3,3,0,0,0,0,54
1140819,56,0,0,0,0,0,0,56
1140820,54,0,0,0,0,0,0,54
1140821,86,3,3,0,0,0,0,92
1140822,68,3,0,3,0,0,0,74
1140823,58,0,0,0,0,0,0,58
1140824,22,3,0,0,0,0,0,25
1140825,60,0,0,0,0,0,0,60
1140826,72,4,0,0,0,0,0,76
1140827,48,0,0,0,3,0,0,51
1140828,85,0,4,0,0,0,0,89
1140829,71,0,3,0,0,0,0,74
1140830,31,3,3,0,0,0,0,37
1140831,60,4,3,0,0,0,0,67
1140832,46,4,0,0,0,0,0,50
1140833,35,0,0,0,0,0,0,35
1140834,72,3,0,0,0,0,0,75
1140835,66,3,0,0,0,0,0,69
1140836,60,6,3,0,0,0,0,69
1140837,77,0,5,0,0,0,0,82
1140838,107,0,4,0,0,0,0,111
1140839,40,0,0,0,0,0,0,40
1140840,57,3,0,3,0,0,0,63
1140841,61,3,3,3,0,0,0,70
1140842,54,0,0,0,0,0,0,54
1140843,46,0,0,0,0,0,0,46
1140844,71,0,3,0,0,0,0,74
1140845,98,3,0,0,0,0,0,101
1140846,57,0,3,0,0,0,0,60
1140847,56,0,0,3,0,0,0,59
1140848,64,3,0,3,0,0,0,70
1140849,54,5,0,0,0,0,0,59
1140850,70,0,0,0,0,0,0,70
1140851,59,0,0,0,0,0,0,59
1140852,59,0,0,0,0,0,0,59
1140853,61,3,3,0,0,0,0,67
1140854,32,0,3,0,0,0,0,35
1140901,0,0,0,0,0,0,0,0
1140902,65,4,0,0,0,0,0,69
1140903,55,0,3,0,0,0,0,58
1140904,59,3,3,0,0,0,0,65
1140905,64,4,0,0,0,0,0,68
1140906,47,3,3,0,0,0,0,53
1140907,90,3,0,0,0,0,0,93
1140908,73,3,3,0,0,0,0,79
1140909,54,4,0,0,0,0,0,58
1140910,44,3,0,0,0,0,0,47
1140911,75,0,0,0,0,0,0,75
1140912,46,0,0,4,0,0,0,50
1140913,61,3,0,0,0,0,3,67
1140914,102,0,3,3,0,0,0,108
1140915,70,0,0,0,0,0,0,70
1140916,52,3,0,0,0,0,0,55
1140917,85,0,0,0,0,0,0,85
1140918,63,0,0,3,0,0,0,66
1140919,63,6,0,0,0,0,0,69
1140920,98,4,3,3,0,0,0,108
1140921,81,0,0,0,0,0,0,81
1140922,46,4,0,0,0,0,0,50
1140923,65,4,3,0,0,0,0,72
1140924,81,3,0,0,0,0,0,84
1140925,122,8,0,0,0,0,0,130
1140926,58,3,0,0,0,0,0,61
1140927,78,3,0,0,0,0,0,81
1140928,52,4,3,0,0,0,0,59
1140929,91,3,0,0,0,0,0,94
1140930,36,3,0,0,0,0,0,39
1140931,76,0,0,3,0,0,0,79
1140932,78,0,3,0,0,0,0,81
1140933,96,0,3,0,0,0,0,99
1140934,61,0,0,0,0,0,0,61
1140935,69,4,0,3,0,0,0,76
1140936,78,0,4,0,0,0,0,82
1140937,68,8,0,0,0,0,0,76
1141001,56,3,3,0,0,0,3,65
1141002,37,7,0,0,0,0,0,44
1141003,60,4,0,0,0,0,0,64
1141004,40,0,0,0,0,0,0,40
1141005,46,0,0,0,0,3,0,49
1141006,71,3,3,0,0,0,0,77
1141007,97,4,0,0,0,0,0,101
1141008,58,0,0,0,0,0,0,58
1141009,62,3,3,3,0,0,0,71
1141010,73,4,0,0,0,0,0,77
1141011,111,4,0,0,0,0,0,115
1141012,66,4,0,0,0,0,0,70
1141013,94,0,0,4,0,0,0,98
1141014,35,3,0,0,0,0,0,38
1141015,63,5,3,0,0,0,0,71
1141016,62,7,0,0,0,0,0,69
1141017,107,3,0,0,0,0,0,110
1141018,70,0,5,0,0,0,0,75
1141019,0,0,0,0,0,0,0,0
1141020,79,3,6,0,0,0,0,88
1141021,60,4,0,0,0,0,0,64
1141022,77,3,3,0,0,0,0,83
1141023,60,3,3,0,0,0,0,66
1141024,73,4,0,0,0,0,0,77
1141025,65,0,3,0,0,0,0,68
1141026,0,0,0,0,0,0,0,0
1141027,69,5,4,0,0,0,0,78
1141028,78,0,0,0,0,0,0,78
1141029,44,0,0,0,0,0,0,44
1141030,78,6,0,0,0,0,0,84
1141031,73,4,0,0,0,0,0,77
1141032,65,6,3,0,0,0,0,74
1141033,47,3,3,0,0,0,0,53
1141034,66,4,0,0,0,0,4,74
1141035,70,0,0,4,0,0,0,74
1141036,115,8,0,0,0,0,0,123
1141037,58,3,0,0,0,0,0,61
1141038,62,5,0,0,0,0,0,67
1141039,57,6,3,0,0,0,0,66
1141040,62,7,3,0,0,0,0,72
1141041,66,3,0,3,0,0,0,72
1141042,27,3,0,0,0,0,0,30
1141043,102,0,4,4,0,0,0,110
1141101,65,3,0,0,0,0,0,68
1141102,91,3,0,0,0,0,0,94
1141103,75,0,6,0,0,0,0,81
1141104,65,3,7,0,0,0,3,78
1141105,76,3,3,0,0,0,0,82
1141106,42,0,0,0,0,0,0,42
1141107,50,0,0,0,0,0,0,50
1141108,58,3,0,0,0,0,0,61
1141109,35,0,0,0,0,0,0,35
1141110,48,3,0,0,0,0,0,51
1141111,67,0,3,4,0,0,4,78
1141112,47,3,0,0,0,0,0,50
1141113,31,3,5,0,0,0,0,39
1141114,4,0,0,0,0,0,0,4
1141115,62,3,0,0,0,0,0,65
1141116,0,0,0,0,0,0,0,0
1141117,12,3,0,0,0,0,0,15
1141118,59,3,4,0,0,0,0,66
1141119,86,5,0,0,0,0,0,91
1141120,45,0,5,0,0,0,0,50
1141121,38,0,0,0,0,0,0,38
1141122,32,3,0,0,0,0,0,35
1141123,76,4,0,0,0,0,0,80
1141124,63,8,3,0,0,0,0,74
1141125,60,0,3,0,0,0,0,63
1141126,78,3,4,0,0,0,0,85
1141127,80,0,0,0,0,0,0,80
1141128,41,3,0,0,0,0,0,44
1141129,91,0,0,0,0,0,0,91
1141130,85,5,0,0,0,0,0,90
1141131,94,3,3,0,0,0,0,100
1141132,71,0,0,0,0,0,0,71
1141133,74,0,0,0,0,0,0,74
1141134,64,6,0,0,0,0,0,70
1141135,56,0,0,0,0,0,0,56
1141136,74,3,0,3,0,0,0,80
1141137,12,0,0,0,0,0,0,12
1141138,33,6,0,0,0,0,0,39
1141139,47,0,0,0,0,0,0,47
1141140,78,0,0,0,0,0,0,78
1141141,50,0,0,0,0,0,0,50
1141142,70,0,0,0,0,0,0,70
1141143,73,5,0,0,0,0,0,78
1141144,56,0,4,0,0,0,0,60
1141201,77,3,0,0,0,0,0,80
1141202,89,5,3,0,0,0,0,97
1141203,73,0,0,0,0,0,4,77
1141204,14,3,0,0,0,0,0,17
1141205,77,5,3,0,0,0,0,85
1141206,63,0,0,0,0,0,0,63
1141207,94,3,0,0,0,0,0,97
1141208,31,0,0,0,0,0,0,31
1141209,76,0,3,0,0,0,0,79
1141210,57,3,0,0,0,0,0,60
1141211,27,4,0,0,0,0,0,31
1141212,60,3,0,0,0,0,0,63
1141213,77,0,3,0,0,0,0,80
1141214,68,0,3,0,0,0,0,71
1141215,36,3,3,3,0,0,0,45
1141216,97,4,0,0,0,0,0,101
1141217,54,3,4,0,0,0,0,61
1141218,83,6,3,0,0,0,0,92
1141219,71,3,0,0,0,0,0,74
1141220,49,0,0,0,0,0,0,49
1141221,72,0,0,0,0,0,0,72
1141222,62,0,0,0,0,0,0,62
1141223,63,3,0,0,0,0,0,66
1141224,76,3,3,0,0,0,0,82
1141225,47,0,5,0,0,0,0,52
1141226,75,3,3,0,0,0,0,81
1141227,60,8,0,0,0,0,0,68
1141228,49,4,4,0,0,0,0,57
1141229,57,0,0,0,0,0,0,57
1141230,108,4,0,0,0,0,0,112
1141231,56,6,4,0,0,0,0,66
1141232,61,3,0,0,0,0,0,64
1141233,62,0,0,0,0,0,0,62
1141234,87,3,3,0,0,0,0,93
1141235,37,0,3,0,0,0,0,40
1141236,75,5,0,0,0,0,0,80
1141237,88,3,0,0,0,0,0,91
1141238,47,0,3,3,0,0,0,53
1141239,0,0,0,0,0,0,0,0
1141301,27,3,0,0,0,0,0,30
1141302,77,7,4,0,0,0,0,88
1141303,29,3,0,0,0,0,0,32
1141304,62,5,0,0,0,0,0,67
1141305,32,0,0,0,0,0,0,32
1141306,58,4,0,0,0,0,0,62
1141307,24,3,0,0,0,0,0,27
1141308,34,0,0,0,0,0,0,34
1141309,28,3,0,0,0,0,0,31
1141310,36,4,0,0,0,0,0,40
1141311,51,8,0,0,0,0,0,59
1141312,45,3,0,0,0,0,0,48
1141313,41,3,0,0,0,0,0,44
1141314,40,0,3,0,0,0,0,43
1141315,56,3,0,0,0,0,0,59
1141316,32,5,0,0,0,0,0,37
1141317,45,3,3,4,0,0,0,55
1141318,31,0,0,0,0,0,0,31
1141319,55,4,0,0,0,0,0,59
1141320,16,5,0,0,0,0,0,21
1141321,42,0,4,0,0,0,0,46
1141322,46,4,0,0,0,0,0,50
1141323,56,3,0,0,0,0,0,59
1141324,57,7,0,0,0,0,0,64
1141325,47,6,0,0,0,0,0,53
1141326,33,0,0,0,0,0,0,33
1141327,22,0,0,0,0,0,0,22
1141328,23,3,0,0,0,0,0,26
1141329,38,5,0,0,0,0,0,43
1141330,23,6,0,3,0,0,0,32
1141331,25,0,0,0,0,0,0,25
1141332,49,4,0,0,0,0,3,56
1141333,39,0,0,3,0,0,0,42
1141334,43,3,0,0,0,0,0,46
1141335,37,0,0,0,0,0,0,37
1141336,31,3,0,0,0,0,0,34
1141337,24,3,0,0,0,0,0,27
1141338,27,0,0,0,0,0,0,27
1141339,21,6,0,0,0,0,0,27
1141340,28,0,0,0,0,0,0,28
1141341,26,4,0,0,0,0,0,30
1141342,32,4,0,0,0,0,0,36
1141401,14,0,0,0,0,0,0,14
1141402,31,4,0,0,0,0,0,35
1141403,26,4,0,0,0,0,0,30
1141404,20,0,0,0,0,0,4,24
1141405,25,3,0,0,0,0,0,28
1141406,27,3,0,0,0,0,0,30
1141407,25,0,0,0,0,0,0,25
1141408,31,0,0,0,0,0,0,31
1141409,33,3,0,0,0,0,0,36
1141410,45,0,0,0,0,0,0,45
1141411,41,9,0,0,0,0,0,50
1141412,43,3,0,0,0,0,0,46
1141413,19,0,0,0,0,0,0,19
1141414,33,3,0,0,0,0,0,36
1141415,35,0,0,3,0,0,0,38
1141416,25,0,0,0,0,0,0,25
1141417,35,3,3,0,0,0,0,41
1141418,42,3,0,0,0,0,0,45
1141419,47,0,4,0,0,0,0,51
1141420,25,0,0,3,0,0,0,28
1141421,27,3,0,0,0,0,0,30
1141422,19,0,0,3,0,0,0,22
1141423,24,0,3,0,0,0,0,27
1141424,38,8,0,0,0,0,0,46
1141425,21,3,0,0,0,0,0,24
1141426,18,0,0,0,0,0,0,18
1141427,32,0,0,0,0,0,0,32
1141428,30,3,0,0,0,0,0,33
1141429,28,0,0,0,0,0,0,28
1141430,51,3,3,0,0,0,0,57
1141431,30,3,0,0,0,0,0,33
1141432,44,3,0,0,0,0,0,47
1141433,22,7,0,0,0,0,0,29
1141434,21,3,0,0,0,0,0,24
1141435,18,0,0,0,0,0,0,18
1141436,20,0,0,0,0,0,0,20
1141437,17,0,0,0,0,0,0,17
1141438,22,4,0,0,0,0,0,26
1141439,13,0,0,0,0,0,0,13
1141440,11,3,0,0,0,0,0,14
1141441,24,0,0,0,0,0,0,24
1141442,12,0,0,0,0,0,0,12
1141443,14,3,0,0,0,0,0,17
1141444,10,0,0,0,0,0,0,10
1141501,36,0,0,0,0,0,0,36
1141502,33,0,0,0,0,0,0,33
1141503,70,4,0,0,0,0,0,74
1141504,15,0,0,0,0,0,0,15
1141505,58,4,0,0,0,0,0,62
1141506,59,3,0,0,0,0,0,62
1141507,55,0,0,3,0,0,0,58
1141508,54,3,0,0,0,0,0,57
1141509,36,0,0,0,0,0,0,36
1141510,0,0,0,0,0,0,0,0
1141511,62,0,0,0,0,0,0,62
1141512,59,4,0,0,0,0,0,63
1141513,68,3,3,0,0,0,0,74
1141514,69,4,3,0,0,0,0,76
1141515,40,4,0,0,0,0,0,44
1141516,41,0,3,0,0,0,0,44
1141517,43,3,0,0,0,0,0,46
1141518,35,4,3,0,0,0,0,42
1141519,52,3,0,0,0,0,0,55
1141520,17,0,0,0,0,0,0,17
1141521,67,0,4,0,0,0,0,71
1141522,49,0,3,0,0,0,0,52
1141523,32,0,4,0,0,0,0,36
1141524,8,0,0,0,0,0,0,8
1141525,44,0,0,0,0,0,0,44
1141526,20,3,0,0,0,0,0,23
1141527,37,3,0,0,0,0,0,40
1141528,27,3,0,0,0,0,0,30
1141529,23,0,0,0,0,0,0,23
1141530,56,3,0,0,0,0,0,59
1141531,52,4,0,0,0,0,0,56
1141532,88,5,0,0,0,0,0,93
1141533,28,5,0,0,0,0,0,33
1141534,29,0,3,0,0,0,0,32
1141535,85,4,0,0,0,0,0,89
1141536,68,6,0,0,0,0,0,74
1141537,10,0,0,0,0,0,0,10
1141538,57,0,0,0,0,0,0,57
1141539,61,0,0,0,0,0,0,61
1141540,36,0,3,0,0,0,0,39
1141541,54,4,0,0,0,0,0,58
1141542,51,6,0,0,0,0,0,57
1141543,80,6,0,0,0,0,0,86
1141544,26,3,0,0,0,0,0,29
1141545,56,3,0,3,0,0,0,62
1141546,23,0,0,0,0,0,4,27
1141547,45,0,0,0,0,0,0,45
1141548,54,0,0,0,0,0,0,54
1141549,33,3,0,0,0,0,3,39
1141550,37,0,3,0,0,0,0,40
1141551,34,0,0,0,0,0,0,34
1141552,48,0,0,0,0,0,0,48
1141553,42,3,0,0,0,0,0,45
1141554,50,3,3,0,0,0,0,56
1141555,15,4,0,0,0,0,0,19
1141556,14,3,0,0,0,0,0,17
1141557,37,0,0,0,0,0,0,37
1141558,46,0,0,0,0,0,0,46
1141559,65,3,3,0,0,0,0,71
1141560,49,0,0,0,0,0,0,49
1141561,62,3,0,0,0,0,0,65
1141562,50,0,0,0,0,0,0,50
1141563,51,0,0,0,0,0,0,51
1141564,0,0,0,0,0,0,0,0
1141565,34,0,0,0,0,0,0,34
1141566,47,4,3,0,0,0,0,54
1141567,36,3,0,0,0,0,0,39
1141568,24,8,0,0,0,0,0,32
1141569,41,0,0,0,0,0,0,41
1141570,42,0,0,0,0,0,0,42
1141571,35,4,0,0,0,0,0,39
1141601,25,0,0,0,0,0,0,25
1141602,25,0,0,0,0,0,0,25
1141603,20,5,0,0,0,0,0,25
1141604,40,4,0,0,0,0,0,44
1141605,39,0,0,0,0,0,0,39
1141606,52,3,3,0,0,0,0,58
1141607,24,0,0,0,0,0,0,24
1141608,20,0,0,0,0,0,0,20
1141609,43,0,0,0,0,0,0,43
1141610,19,3,0,0,0,0,0,22
1141611,21,3,0,0,0,0,0,24
1141612,26,3,0,0,0,0,0,29
1141613,22,0,0,0,0,0,0,22
1141614,51,4,0,0,0,0,0,55
1141615,32,0,0,0,0,0,0,32
1141616,25,0,4,0,0,0,0,29
1141617,33,0,3,0,0,0,0,36
1141618,12,4,0,0,0,0,0,16
1141619,18,0,0,0,0,0,0,18
1141620,5,0,0,0,0,0,0,5
1141621,26,4,0,0,0,0,0,30
1141622,21,4,0,0,0,0,0,25
1141623,27,0,0,0,0,0,0,27
1141624,20,0,0,0,0,0,0,20
1141625,15,0,0,0,0,0,0,15
1141626,4,0,0,0,0,0,0,4
1141627,33,0,0,0,0,0,0,33
1141628,32,0,0,0,0,0,0,32
1141629,31,0,0,0,0,0,0,31
1141630,19,0,0,0,0,3,0,22
1141631,16,3,0,0,0,0,0,19
1141632,19,5,0,0,0,0,0,24
1141633,32,0,0,0,0,0,0,32
1141634,18,0,0,0,0,0,0,18
1141635,47,4,3,0,0,0,0,54
1141636,26,0,0,0,0,0,0,26
1141637,42,4,0,0,0,0,0,46
1141701,41,0,0,0,0,0,0,41
1141702,7,0,0,0,0,0,0,7
1141703,32,3,0,0,0,0,0,35
1141704,24,0,0,0,0,0,0,24
1141705,0,0,0,0,0,0,0,0
1141706,22,0,0,0,0,0,3,25
1141707,9,0,0,0,0,0,0,9
1141708,25,0,0,0,0,0,0,25
1141709,9,0,0,0,0,0,0,9
1141710,0,0,0,0,0,0,0,0
1141711,0,0,0,0,0,0,0,0
1141712,25,3,0,0,0,0,0,28
1141713,8,0,0,0,0,0,0,8
1141714,35,0,0,0,0,0,0,35
1141715,53,5,4,0,0,0,0,62
1141716,33,0,0,0,0,0,0,33
1141717,23,0,0,0,0,0,0,23
1141718,20,0,0,0,0,0,0,20
1141719,30,3,0,0,0,0,0,33
1141720,49,3,0,0,0,0,0,52
1141721,16,3,0,0,0,0,0,19
1141722,0,0,0,0,0,0,0,0
1141723,39,0,0,3,0,0,0,42
1141724,49,3,0,0,0,0,0,52
1141725,33,0,0,0,0,0,0,33
1141726,14,3,0,0,0,0,0,17
1141727,0,0,0,0,0,0,0,0
1141728,8,4,0,0,0,0,0,12
1141801,37,0,0,0,0,0,0,37
1141802,0,0,0,0,0,0,0,0
1141803,82,0,0,0,0,0,0,82
1141804,83,3,3,0,0,0,0,89
1141805,68,4,3,0,0,0,0,75
1141806,86,5,3,0,0,0,0,94
1141807,106,10,3,0,0,0,0,119
1141808,86,5,3,0,0,0,0,94
1141809,70,3,0,0,0,0,0,73
1141810,45,3,0,0,0,0,0,48
1141811,53,0,0,0,0,0,0,53
1141812,80,0,0,0,0,0,0,80
1141813,88,0,0,0,0,0,0,88
1141814,56,3,0,0,0,0,0,59
1141815,81,9,0,0,0,0,0,90
1141816,62,3,0,0,0,0,0,65
1141817,85,0,0,0,0,0,0,85
1141818,64,3,3,0,0,0,0,70
1141819,83,3,3,0,0,0,0,89
1141820,55,0,0,0,0,0,0,55
1141821,57,6,3,0,0,0,0,66
1141822,69,3,0,0,0,0,0,72
1141823,88,4,3,0,0,0,3,98
1141824,64,6,3,0,0,0,0,73
1141825,91,6,0,0,0,0,0,97
1141826,71,7,3,0,0,3,0,84
1141827,72,3,4,0,0,0,0,79
1141828,43,3,0,0,0,0,0,46
1141829,63,4,0,0,0,0,0,67
1141830,65,4,0,0,0,0,0,69
1141831,42,6,0,0,0,0,0,48
1141832,71,3,0,0,0,0,0,74
1141833,31,4,0,0,0,0,0,35
1141834,54,4,0,0,0,0,0,58
1141835,48,0,0,0,0,0,0,48
1141836,67,9,0,0,0,0,3,79
1141837,43,0,0,0,0,0,0,43
1141838,96,4,0,0,0,0,0,100
1141839,91,0,3,0,0,0,0,94
1141840,68,4,3,3,0,0,0,78
1141841,89,4,4,0,0,0,0,97
1141842,0,0,0,0,0,0,0,0
1141901,22,3,0,0,0,0,0,25
1141902,37,3,3,0,0,0,0,43
1141903,80,3,0,0,0,0,0,83
1141904,42,3,0,0,0,0,0,45
1141905,50,3,0,0,0,0,0,53
1141906,45,3,3,0,0,0,0,51
1141907,37,0,0,0,0,0,0,37
1141908,22,3,3,0,0,0,0,28
1141909,44,3,4,0,0,0,0,51
1141910,37,3,0,0,0,0,0,40
1141911,16,0,0,0,0,0,0,16
1141912,36,0,0,0,0,0,0,36
1141913,12,0,0,0,0,0,0,12
1141914,33,0,0,0,0,0,0,33
1141915,28,0,0,0,0,0,0,28
1141916,34,3,3,0,0,0,0,40
1141917,48,0,0,4,0,0,0,52
1141918,51,4,0,0,0,0,0,55
1141919,55,3,3,0,0,0,0,61
1141920,62,0,0,0,0,0,0,62
1141921,31,3,0,0,0,0,0,34
1141922,21,5,0,0,0,0,0,26
1141923,10,0,0,0,0,0,0,10
1141924,22,4,0,0,0,0,0,26
1141925,15,0,0,0,0,0,0,15
1141926,41,3,0,0,0,0,0,44
1141927,30,0,0,0,0,0,0,30
1141928,21,0,0,0,0,0,0,21
1141929,34,3,0,0,0,0,0,37
1141930,13,0,0,0,0,0,0,13
1141931,32,3,0,0,0,0,0,35
1141932,44,3,3,0,0,0,0,50
1141933,39,8,0,0,0,0,0,47
1141934,44,0,0,0,0,0,0,44
1141935,34,0,0,0,0,0,0,34
1141936,37,4,0,0,0,0,0,41
1141937,48,3,0,0,0,0,0,51
1141938,70,3,3,0,0,0,0,76
1141939,3,0,0,0,0,0,0,3
1141940,51,5,4,0,0,0,0,60
1141941,24,0,0,0,0,0,0,24
1141942,0,0,0,0,0,0,0,0
1141943,68,0,0,0,0,0,0,68
1141944,50,3,3,0,0,0,0,56
1141945,70,3,3,0,0,0,0,76
1141946,12,3,0,0,0,0,0,15
1141947,28,0,0,0,0,0,0,28
1141948,20,0,0,0,0,0,0,20
1142001,58,8,0,3,0,3,0,72
1142002,43,0,3,0,0,0,0,46
1142003,14,0,0,0,0,0,0,14
1142004,40,9,0,3,0,0,0,52
1142005,31,4,0,0,0,0,0,35
1142006,26,0,0,0,0,0,0,26
1142007,54,10,0,0,0,0,0,64
1142008,37,0,0,4,0,0,0,41
1142009,51,4,0,0,0,0,0,55
1142010,33,3,3,4,0,0,0,43
1142011,62,6,0,0,0,0,0,68
1142012,33,3,0,0,0,0,0,36
1142013,62,4,0,0,0,0,0,66
1142014,58,3,3,0,0,0,0,64
1142015,47,5,3,0,0,0,0,55
1142016,79,6,0,0,0,0,0,85
1142017,85,13,3,0,0,0,0,101
1142018,0,0,0,0,0,0,0,0
1142019,0,0,0,0,0,0,0,0
1142020,74,0,3,0,0,0,0,77
1142021,46,4,0,0,0,0,0,50
1142022,24,8,0,0,0,0,0,32
1142023,55,3,3,3,0,0,0,64
1142024,82,8,3,0,0,0,0,93
1142025,71,5,0,0,0,0,0,76
1142026,72,3,3,0,0,0,0,78
1142027,49,3,0,0,0,0,0,52
1142028,30,3,0,0,0,0,0,33
1142029,65,7,0,0,0,0,0,72
1142030,92,5,3,0,0,0,0,100
1142101,99,10,4,0,0,0,0,113
1142102,89,3,3,0,0,0,0,95
1142103,61,0,0,0,0,0,0,61
1142104,77,0,0,0,0,0,3,80
1142105,78,10,6,0,0,0,0,94
1142106,95,4,3,0,0,0,0,102
1142107,36,0,0,0,0,0,0,36
1142108,42,4,0,0,0,0,0,46
1142109,86,3,3,0,0,0,0,92
1142110,38,3,0,0,0,0,0,41
1142111,76,3,3,0,0,0,0,82
1142112,28,5,5,0,0,0,0,38
1142113,44,0,0,0,0,0,0,44
1142114,66,4,0,0,0,0,0,70
1142115,48,4,0,0,0,0,0,52
1142116,68,0,0,0,0,0,0,68
1142117,65,4,3,0,0,0,0,72
1142118,50,5,7,0,0,0,0,62
1142119,22,3,0,0,0,0,0,25
1142120,29,4,0,0,0,0,0,33
1142121,51,4,3,0,0,0,0,58
1142122,57,3,4,0,0,0,0,64
1142123,24,4,0,0,0,0,0,28
1142201,54,4,3,3,0,0,0,64
1142202,23,7,0,0,0,0,0,30
1142203,26,0,0,0,0,0,0,26
1142204,71,3,0,0,0,0,0,74
1142205,58,3,3,3,0,0,0,67
1142206,43,0,0,0,0,0,0,43
1142207,51,7,3,0,0,0,0,61
1142208,47,0,0,0,0,0,3,50
1142209,32,4,0,0,0,0,0,36
1142210,52,0,0,0,0,0,0,52
1142211,73,10,7,0,0,0,0,90
1142212,33,5,0,0,0,0,0,38
1142213,36,5,0,0,0,0,0,41
1142214,29,3,0,0,0,0,0,32
1142215,40,3,0,0,0,0,0,43
1142216,41,7,0,0,0,0,0,48
1142217,37,6,0,0,0,0,0,43
1142218,33,3,3,0,0,0,0,39
1142219,52,5,0,0,0,0,0,57
1142220,73,3,3,0,0,0,0,79
1142221,55,4,0,0,0,0,0,59
1142222,78,3,4,0,0,0,0,85
1142223,23,5,0,0,0,0,0,28
1142224,38,0,0,0,0,0,0,38
1142225,47,5,3,0,0,0,0,55
1142226,65,5,3,3,0,0,0,76
1142227,69,5,3,0,0,0,0,77
1142228,52,4,0,0,0,0,0,56
1142229,36,3,0,0,0,0,0,39
1142230,62,5,0,0,0,0,0,67
1142231,52,4,3,0,0,0,0,59
1142232,23,0,0,3,0,0,0,26
1142233,60,3,0,0,0,0,0,63
1142234,45,0,0,0,0,0,0,45
1142301,58,4,4,0,0,0,0,66
1142302,75,6,3,0,0,0,0,84
1142303,78,8,4,0,0,0,0,90
1142304,48,3,0,0,0,0,0,51
1142305,61,5,3,3,0,0,0,72
1142306,52,7,0,0,0,0,0,59
1142307,60,0,3,0,0,0,0,63
1142308,40,8,0,0,0,0,0,48
1142309,69,6,3,0,0,0,3,81
1142310,61,0,0,0,0,0,0,61
1142311,27,5,9,0,0,0,0,41
1142312,58,3,0,0,0,0,0,61
1142313,64,6,0,0,0,0,0,70
1142314,67,4,0,0,0,0,0,71
1142315,58,6,0,0,0,0,0,64
1142316,62,5,4,3,0,0,0,74
1142317,62,4,5,0,0,0,0,71
1142318,131,5,5,0,0,0,4,145
1142319,137,10,3,0,0,0,0,150
1142320,43,5,3,0,0,0,0,51
1142321,77,3,3,0,0,0,4,87
1142322,63,4,0,0,0,0,0,67
1142323,51,3,3,0,0,0,0,57
1142324,49,0,3,0,0,0,0,52
1142325,37,0,0,0,0,0,0,37
1142326,70,3,3,0,0,0,0,76
1142327,36,0,0,3,0,0,0,39
1142328,63,4,3,4,0,0,0,74
1142329,66,3,0,0,0,0,0,69
1142330,60,3,3,0,0,0,0,66
1142331,16,0,4,0,0,0,0,20
1142332,59,9,3,0,0,0,0,71
1142333,37,3,0,0,0,0,0,40
1142334,80,9,0,0,0,0,0,89
1142335,73,5,5,0,0,0,0,83
1142336,36,3,0,3,0,0,0,42
1142337,63,0,0,5,0,0,0,68
1142338,41,0,3,0,0,0,0,44
1142339,43,3,0,0,0,0,0,46
1142340,31,6,3,0,0,0,3,43
1142341,34,0,0,0,0,0,0,34
1142342,27,3,3,0,0,0,0,33
1142343,3,0,0,0,0,0,0,3
1142344,33,8,0,0,0,0,0,41
1142345,69,3,0,0,0,0,0,72
1142346,87,0,8,0,0,0,0,95
1142347,65,3,4,0,0,0,0,72
1142348,53,3,4,0,0,0,0,60
1142401,73,3,3,3,0,0,0,82
1142402,62,0,0,0,0,0,0,62
1142403,60,5,0,0,0,0,0,65
1142404,41,3,3,3,0,0,0,50
1142405,23,5,3,0,0,0,0,31
1142406,64,3,0,0,0,0,0,67
1142407,55,0,0,0,0,0,0,55
1142408,60,0,3,3,0,0,0,66
1142409,67,5,4,0,0,0,0,76
1142410,82,5,0,0,0,0,0,87
1142411,58,3,0,0,0,0,0,61
1142412,58,3,3,3,0,0,0,67
1142413,63,6,0,3,0,0,0,72
1142414,66,0,0,0,0,0,0,66
1142415,44,0,0,0,0,0,0,44
1142416,46,0,0,0,0,0,0,46
1142417,43,0,0,3,0,0,0,46
1142418,80,7,0,0,0,0,0,87
1142419,96,4,4,0,0,0,0,104
1142420,47,4,0,0,0,0,0,51
1142421,34,3,0,0,0,0,0,37
1142422,72,0,5,0,0,0,0,77
1142423,62,5,0,0,0,0,0,67
1142424,56,10,0,0,0,0,0,66
1142425,30,3,4,0,0,0,0,37
1142426,35,3,3,0,0,0,0,41
1142427,48,3,3,0,0,0,0,54
1142428,55,7,0,0,0,3,0,65
1142429,41,6,0,0,0,0,0,47
1142430,40,0,3,0,0,0,0,43
1142431,51,6,0,0,0,0,0,57
1142432,23,4,0,0,0,0,0,27
1142433,22,3,3,0,0,0,0,28
1142501,42,4,0,0,0,0,0,46
1142502,34,4,3,3,0,0,0,44
1142503,20,3,3,0,0,0,0,26
1142504,23,3,3,4,0,0,0,33
1142505,43,3,0,0,0,0,0,46
1142506,45,3,0,3,0,0,0,51
1142507,67,4,0,0,0,0,0,71
1142508,43,4,0,0,0,0,0,47
1142509,52,6,0,0,0,0,0,58
1142510,39,0,3,0,3,0,0,45
1142511,31,3,0,0,0,0,0,34
1142512,36,3,3,0,0,0,0,42
1142513,51,3,0,0,0,0,0,54
1142514,68,3,3,4,0,0,0,78
1142515,14,0,0,0,0,0,0,14
1142516,65,4,4,0,0,0,0,73
1142517,47,3,3,3,0,0,0,56
1142518,90,5,7,0,0,0,0,102
1142519,64,4,0,0,0,0,0,68
1142520,0,0,0,0,0,0,0,0
1142521,56,0,0,0,0,0,0,56
1142522,3,0,0,0,0,0,0,3
1142523,40,5,4,0,0,0,0,49
1142601,73,8,3,0,0,0,0,84
1142602,44,0,0,0,0,0,0,44
1142603,52,0,0,0,0,0,0,52
1142604,43,7,0,0,0,0,0,50
1142605,40,3,0,3,0,0,0,46
1142606,41,3,3,3,0,0,0,50
1142607,21,3,0,0,0,0,0,24
1142608,51,7,0,0,0,0,0,58
1142609,24,0,0,0,0,0,0,24
1142610,48,4,0,0,0,0,0,52
1142611,21,0,0,0,0,0,0,21
1142612,59,7,0,0,0,0,0,66
1142613,29,0,0,0,0,0,0,29
1142614,14,0,0,0,0,0,0,14
1142615,53,3,0,0,0,0,0,56
1142616,72,3,3,0,0,0,0,78
1142617,34,5,0,0,0,0,0,39
1142618,31,3,4,0,0,0,0,38
1142619,33,3,0,0,0,0,0,36
1142620,40,3,3,0,0,0,0,46
1142621,25,3,0,0,0,0,3,31
1142622,27,0,3,0,0,0,0,30
1142623,23,7,0,0,0,0,0,30
1142624,12,0,3,0,0,0,0,15
1142625,28,0,0,0,0,0,0,28
1142626,22,4,0,0,0,0,0,26
1142627,20,0,0,0,0,0,0,20
1142628,41,3,0,0,0,3,0,47
1142629,28,5,3,0,0,0,0,36
1142630,37,0,0,0,0,0,0,37
1142631,39,4,4,0,0,0,0,47
1142632,54,4,0,0,0,0,0,58
1142633,40,5,0,0,0,0,0,45
1142634,41,4,0,0,0,0,0,45
1142635,39,0,0,0,3,0,0,42
1142636,28,3,0,0,0,0,0,31
1142637,54,5,0,0,0,0,0,59
1142638,42,6,3,0,0,0,0,51
1142639,54,7,0,0,0,0,0,61
1142640,31,0,3,0,0,0,3,37
1142641,75,4,4,0,0,0,0,83
1142642,32,4,0,0,0,0,0,36
1142643,30,5,3,0,0,0,0,38
1142644,29,9,0,0,0,0,0,38
1142645,71,10,0,0,0,0,0,81
1142646,60,3,0,0,0,0,0,63
1142647,38,4,5,0,0,0,0,47
1142648,68,3,3,0,0,0,0,74
1142649,86,3,4,0,0,0,0,93
1142650,54,4,0,0,0,0,0,58
1142651,50,3,3,0,0,0,0,56
1142652,73,8,0,0,0,0,0,81
1142653,30,6,0,0,0,0,0,36
1142654,39,0,0,3,0,0,0,42
1142655,40,8,0,4,0,0,0,52
1142656,45,3,0,0,0,0,0,48
1142701,49,4,0,0,0,0,0,53
1142702,65,0,3,0,0,0,0,68
1142703,36,3,0,0,0,0,0,39
1142704,37,3,0,0,0,0,0,40
1142705,21,3,0,0,0,0,0,24
1142706,29,4,0,0,0,0,0,33
1142707,37,4,0,0,0,0,0,41
1142708,53,3,0,0,0,0,0,56
1142709,84,6,0,0,0,0,0,90
1142710,48,0,0,0,0,0,0,48
1142711,56,4,0,0,0,0,0,60
1142712,41,0,0,0,0,0,0,41
1142713,64,0,0,0,0,0,0,64
1142714,56,0,5,0,0,0,0,61
1142715,35,0,0,0,0,0,0,35
1142716,43,0,3,0,0,0,0,46
1142717,45,3,0,0,0,0,0,48
1142718,77,3,0,0,0,3,0,83
1142719,60,0,0,0,0,0,0,60
1142720,52,4,0,0,0,0,0,56
1142721,61,0,5,0,0,0,0,66
1142722,0,0,0,0,0,0,0,0
1142723,34,0,0,0,0,0,0,34
1142724,0,0,0,0,0,0,0,0
1142725,0,0,0,0,0,0,0,0
1142726,63,3,0,0,0,0,0,66
1142727,53,0,0,0,0,0,0,53
1142728,56,4,0,0,0,0,0,60
1142729,58,0,0,0,0,0,0,58
1142730,0,0,0,0,0,0,0,0
1142731,0,0,0,0,0,0,0,0
1142732,49,0,4,0,0,0,0,53
1142733,37,0,0,0,0,0,0,37
1142734,51,0,3,0,0,0,0,54
1142735,51,3,0,0,0,0,0,54
1142736,47,4,0,0,0,0,0,51
1142737,55,0,3,0,0,0,0,58
1142738,47,3,3,0,0,0,0,53
1142739,62,3,4,0,0,0,0,69
1142740,38,0,3,0,0,0,0,41
1142741,71,5,0,0,0,0,0,76
1142801,47,4,0,0,0,0,0,51
1142802,80,4,3,0,0,0,0,87
1142803,89,7,0,0,0,0,0,96
1142804,93,3,0,0,0,0,0,96
1142805,65,3,4,0,0,0,0,72
1142806,85,7,0,0,0,0,0,92
1142807,64,0,0,3,0,0,0,67
1142808,43,5,3,0,0,0,0,51
1142809,53,3,3,0,0,0,0,59
1142810,44,3,0,0,0,0,0,47
1142811,49,3,0,0,0,0,0,52
1142812,61,6,4,0,0,0,0,71
1142813,46,3,0,0,0,0,0,49
1142814,65,4,0,0,0,0,0,69
1142815,46,5,0,0,0,0,0,51
1142816,51,0,0,0,0,0,0,51
1142817,80,3,0,0,0,0,0,83
1142818,73,3,3,0,0,0,0,79
1142819,61,4,3,0,0,0,0,68
1142820,17,4,0,0,0,0,0,21
1142821,88,0,4,0,0,0,0,92
1142822,25,0,0,0,0,0,0,25
1142823,62,0,0,0,0,0,0,62
1142824,46,5,3,0,0,0,0,54
1142825,0,0,0,0,0,0,0,0
1142826,50,3,0,3,0,0,3,59
1142827,40,5,3,0,0,0,0,48
1142828,77,4,4,0,0,0,0,85
1142829,45,3,3,0,0,0,0,51
1142830,62,0,3,0,0,0,0,65
1142831,63,3,0,3,0,0,0,69
1142832,73,6,3,3,0,0,0,85
1142833,66,0,3,0,0,0,0,69
1142834,69,3,6,0,0,0,0,78
1142835,74,3,0,0,0,0,0,77
1142836,74,6,0,4,0,0,0,84
1142837,34,3,3,0,0,0,0,40
1142838,0,0,0,0,0,0,0,0
1142839,43,5,0,0,0,0,0,48
1142840,54,4,0,0,0,0,0,58
1142841,7,0,0,0,0,0,0,7
1142842,79,3,0,0,0,0,0,82
1142843,61,3,0,0,0,3,0,67
1142844,61,0,3,0,0,0,0,64
1142845,60,6,3,0,0,0,0,69
1142846,27,8,3,0,0,0,0,38
1142847,90,4,3,0,0,0,0,97
1142848,77,0,0,6,0,0,0,83
1142849,51,0,0,0,0,0,0,51
1142850,53,3,0,0,0,0,0,56
1142851,79,3,3,0,0,0,0,85
1142852,49,4,3,0,0,0,0,56
1142853,43,0,0,0,0,0,0,43
1142854,49,0,0,0,0,0,0,49
1142855,69,8,0,0,0,0,0,77
1142856,55,0,0,0,0,0,0,55
1142857,72,6,4,0,0,0,0,82
1142858,44,3,3,0,0,0,0,50
1142859,41,3,0,0,0,0,0,44
1142860,62,4,3,0,0,0,0,69
1142861,0,0,0,0,0,0,0,0
1142862,50,0,0,4,0,0,0,54
1142863,52,0,3,0,0,0,0,55
1142864,93,6,0,0,0,0,0,99
1142901,53,3,3,0,0,0,0,59
1142902,65,4,0,0,0,0,0,69
1142903,61,0,0,0,0,0,0,61
1142904,27,3,0,0,0,0,0,30
1142905,86,5,0,0,0,0,0,91
1142906,71,4,0,0,3,0,0,78
1142907,29,6,0,0,0,0,0,35
1142908,61,3,3,0,0,0,0,67
1142909,57,4,0,0,0,0,0,61
1142910,27,0,0,0,0,0,0,27
1142911,40,0,0,0,0,0,0,40
1142912,40,0,0,3,0,0,0,43
1142913,28,3,0,0,0,0,0,31
1142914,69,3,3,0,0,0,0,75
1142915,17,3,0,0,0,0,0,20
1142916,19,3,0,0,0,0,0,22
1142917,82,7,3,0,0,0,0,92
1142918,0,0,0,0,0,0,0,0
1142919,4,0,0,0,0,0,0,4
1142920,10,4,0,0,0,0,0,14
1142921,45,0,4,0,0,0,0,49
1142922,55,3,3,0,0,0,0,61
1142923,43,0,0,0,0,0,0,43
1142924,19,0,0,0,0,0,0,19
1142925,37,0,0,0,0,0,0,37
1142926,28,0,0,0,0,0,0,28
1142927,35,0,0,0,0,0,0,35
1142928,17,0,0,0,0,0,0,17
1142929,80,3,6,0,0,0,0,89
1142930,0,0,0,0,0,0,0,0
1142931,48,0,3,4,0,0,0,55
1142932,47,0,4,0,0,0,0,51
1142933,73,0,6,0,0,0,0,79
1142934,42,0,0,0,0,0,0,42
1142935,0,0,0,0,0,0,0,0
1142936,18,0,4,0,0,0,0,22
1142937,67,3,8,0,0,0,0,78
1142938,43,5,3,0,0,0,0,51
1142939,47,0,0,0,0,0,0,47
1142940,86,5,0,0,0,0,0,91
1142941,54,3,0,0,0,0,0,57
1142942,45,3,0,0,0,0,0,48
1142943,62,5,0,0,0,0,0,67
1142944,40,4,5,0,0,0,0,49
1142945,47,3,3,0,0,0,0,53
1142946,31,5,0,0,0,0,0,36
1142947,32,3,0,0,0,0,0,35
1142948,45,3,0,0,0,0,0,48
1142949,29,0,0,0,0,0,0,29
1142950,20,3,0,0,0,0,0,23
1142951,72,4,4,0,0,0,0,80
1143001,25,5,0,0,0,0,0,30
1143002,65,6,3,0,0,0,0,74
1143003,60,6,3,0,0,0,0,69
1143004,79,4,0,0,0,0,0,83
1143005,75,3,4,0,0,0,0,82
1143006,104,5,0,0,0,0,0,109
1143007,30,0,4,0,0,0,0,34
1143008,21,3,3,0,0,0,0,27
1143009,86,7,0,0,0,0,0,93
1143010,69,4,3,3,0,0,0,79
1143011,72,4,0,0,0,0,0,76
1143012,0,0,0,0,0,0,0,0
1143013,45,0,0,3,0,0,0,48
1143014,52,3,0,0,0,0,0,55
1143015,55,3,0,0,0,0,0,58
1143016,53,4,3,0,0,0,0,60
1143017,36,3,3,0,0,0,0,42
1143018,27,5,0,0,0,0,0,32
1143019,33,3,3,0,0,0,0,39
1143020,41,3,3,0,0,0,0,47
1143021,55,3,0,0,0,0,0,58
1143022,75,3,4,0,0,0,0,82
1143023,56,0,0,0,0,0,0,56
1143024,78,8,3,0,0,0,3,92
1143025,71,5,5,0,0,0,0,81
1143026,51,0,0,0,0,0,0,51
1143027,58,0,0,0,0,0,0,58
1143028,54,5,0,0,0,0,0,59
1143029,78,7,0,0,0,0,0,85
1143030,73,3,3,3,0,0,0,82
1143031,51,3,0,0,0,0,0,54
1143032,59,3,0,0,0,0,0,62
1143033,70,6,4,0,0,0,0,80
1143034,55,5,3,0,0,0,0,63
1143035,34,3,3,3,0,0,0,43
1143036,81,3,0,0,0,0,0,84
1143037,44,0,3,3,0,0,0,50
1143038,64,0,0,0,0,0,0,64
1143101,40,0,3,0,0,0,0,43
1143102,31,3,0,0,0,0,0,34
1143103,17,3,0,0,0,0,0,20
1143104,16,3,0,0,0,0,0,19
1143105,35,3,0,0,0,0,0,38
1143106,77,3,0,0,0,0,0,80
1143107,37,3,3,0,0,0,0,43
1143108,29,5,0,0,0,0,0,34
1143109,15,4,0,0,0,0,0,19
1143110,19,3,0,0,0,0,0,22
1143111,37,6,0,0,0,0,0,43
1143112,6,0,0,0,0,0,0,6
1143113,40,0,0,0,0,0,0,40
1143114,35,3,3,3,0,0,0,44
1143115,0,0,0,0,0,0,0,0
1143116,20,3,0,0,0,0,0,23
1143117,81,3,3,0,0,0,0,87
1143118,74,4,3,3,0,0,3,87
1143119,24,3,0,0,0,0,0,27
1143120,42,4,4,0,0,0,0,50
1143121,14,0,0,0,0,0,0,14
1143122,53,6,0,0,0,0,0,59
1143123,41,0,0,0,0,0,0,41
1143124,39,6,3,0,0,0,0,48
1143125,65,7,3,3,0,0,0,78
1143126,61,4,3,0,0,0,0,68
1143127,73,4,7,3,0,0,0,87
1143128,55,8,4,0,0,0,0,67
1143129,68,0,3,0,0,0,0,71
1143130,59,0,0,3,0,0,0,62
1143131,71,3,3,0,0,3,0,80
1143132,26,3,5,0,0,0,0,34
1143133,55,5,3,0,0,0,0,63
1143134,34,3,0,0,0,0,0,37
1143135,36,4,3,0,0,0,0,43
1143136,45,0,4,0,0,0,0,49
1143137,79,5,5,0,0,0,0,89
1143138,81,3,7,0,0,0,0,91
1143139,53,0,0,3,0,0,0,56
1143140,53,3,3,0,0,0,0,59
1143141,63,4,3,0,0,0,0,70
1143142,43,6,0,0,0,0,0,49
1143143,54,3,0,0,0,0,0,57
1143144,63,0,4,3,0,0,0,70
1143145,14,0,0,6,0,0,0,20
1143146,49,5,0,3,0,0,0,57
1143147,66,0,0,0,0,0,0,66
1143148,90,3,3,0,0,0,0,96
1143149,44,0,0,0,0,0,0,44
1143150,34,8,0,0,0,0,0,42
1143151,42,7,3,0,0,0,0,52
1143152,43,7,0,0,0,3,0,53
1143153,25,3,0,0,0,0,0,28
1143154,29,0,4,0,0,0,0,33
1143155,25,0,0,0,0,0,0,25
1143156,48,3,3,0,0,0,0,54
1143201,32,7,3,0,0,0,0,42
1143202,65,3,3,0,0,0,0,71
1143203,20,3,3,0,0,0,0,26
1143204,79,0,3,0,0,0,0,82
1143205,0,0,0,0,0,0,0,0
1143206,5,4,0,0,0,0,0,9
1143207,0,0,0,0,0,0,0,0
1143208,31,6,3,0,0,0,0,40
1143209,30,0,3,0,0,0,0,33
1143210,45,0,0,0,0,0,0,45
1143211,38,3,0,0,0,0,0,41
1143212,88,3,6,3,0,0,0,100
1143213,39,3,3,0,0,0,0,45
1143214,38,0,3,0,0,0,0,41
1143301,35,3,0,0,0,0,0,38
1143302,3,0,0,0,0,0,0,3
1143303,97,5,3,0,3,0,0,108
1143304,13,0,0,0,0,0,0,13
1143305,76,10,6,3,0,0,0,95
1143306,133,13,5,0,0,0,0,151
1143307,75,0,0,0,0,0,0,75
1143308,55,5,4,0,0,0,0,64
1143309,20,3,3,0,0,0,0,26
1143310,47,3,4,0,0,0,0,54
1143311,43,3,3,0,0,0,0,49
1143312,41,0,0,0,0,0,0,41
1143313,38,4,0,0,0,0,0,42
1143314,34,5,3,0,0,0,3,45
1143315,18,0,3,0,0,0,0,21
1143316,83,3,4,0,0,0,0,90
1143317,83,9,3,0,0,0,0,95
1143318,44,6,3,0,0,0,3,56
1143319,60,4,5,0,0,0,0,69
1143320,39,0,4,0,0,0,0,43
1143321,40,7,7,0,0,0,0,54
1143322,59,6,6,5,0,0,0,76
1143323,45,9,8,0,0,0,0,62
1143324,55,4,0,0,0,0,0,59
1143325,40,7,0,0,0,0,0,47
1143326,51,0,7,0,0,0,0,58
1143327,68,5,0,3,0,0,0,76
1143401,49,4,3,0,0,0,0,56
1143402,49,5,0,0,0,0,4,58
1143403,68,8,3,0,3,0,0,82
1143404,49,3,5,3,0,0,0,60
1143405,82,5,7,4,0,0,0,98
1143406,72,4,8,0,0,0,0,84
1143407,50,0,4,0,0,0,0,54
1143408,70,7,5,0,0,0,0,82
1143409,75,7,3,0,0,3,0,88
1143410,105,7,9,0,0,0,0,121
1143411,74,3,7,0,0,0,0,84
1143412,49,3,3,0,0,0,0,55
1143413,75,6,4,0,0,0,0,85
1143414,68,3,4,0,0,0,0,75
1143415,34,7,3,0,0,0,0,44
1143416,52,5,5,0,0,0,0,62
1143417,33,4,5,0,0,0,0,42
1143418,53,6,0,0,0,0,0,59
1143419,31,0,3,0,0,0,0,34
1143420,39,0,6,0,0,0,0,45
1143421,85,7,6,0,0,0,0,98
1143422,5,0,0,0,0,0,0,5
1143423,0,0,0,0,0,0,0,0
1143424,40,5,0,0,0,0,0,45
1143425,36,0,5,0,0,0,0,41
1143426,33,3,3,0,0,0,0,39
1143427,63,6,6,0,0,0,0,75
1143428,48,0,0,3,0,0,3,54
1143429,73,3,3,0,0,0,0,79
1143430,32,3,0,3,0,0,0,38
1143431,31,5,0,0,0,0,0,36
1143432,26,3,0,0,0,0,0,29
1143433,29,5,3,3,0,0,0,40
1143434,52,7,3,0,0,0,0,62
1143435,56,9,0,3,0,0,3,71
1143436,62,3,8,0,0,0,0,73
1143437,26,0,0,0,0,0,0,26
1143438,40,3,3,0,0,0,3,49
1143439,119,10,0,0,0,0,4,133
1143440,36,3,0,0,0,0,0,39
1143441,0,0,0,0,0,0,0,0
1143442,40,0,4,0,0,0,0,44
1143443,32,0,3,0,0,0,0,35
1143444,42,6,7,0,0,0,0,55
1143501,48,7,3,0,0,0,0,58
1143502,49,5,0,0,0,0,0,54
1143503,66,3,3,0,0,0,0,72
1143504,50,5,4,0,0,0,0,59
1143505,54,4,5,0,0,0,0,63
1143506,79,7,0,0,0,0,0,86
1143507,88,8,7,0,0,0,0,103
1143508,43,10,7,3,0,0,0,63
1143509,71,5,7,0,0,0,0,83
1143510,47,3,0,0,0,0,0,50
1143511,3,0,0,0,0,0,0,3
1143512,37,5,0,5,0,0,0,47
1143513,44,4,4,0,0,0,0,52
1143514,63,6,3,0,0,0,0,72
1143515,32,4,0,0,0,0,0,36
1143516,69,3,4,0,0,0,0,76
1143517,52,9,3,0,0,0,0,64
1143518,92,6,4,0,0,0,0,102
1143519,52,6,3,0,0,0,0,61
1143520,70,6,5,0,0,0,0,81
1143521,59,4,5,0,0,0,0,68
1143522,67,3,9,0,0,0,0,79
1143523,72,4,4,0,0,0,0,80
1143524,47,3,3,0,0,0,0,53
1143525,70,10,4,0,0,0,0,84
1143526,93,12,7,0,0,0,0,112
1143527,48,3,4,0,0,0,0,55
1143528,54,0,0,5,0,0,0,59
1143529,65,10,5,3,0,0,0,83
1143530,57,3,5,0,0,0,0,65
1143531,59,7,3,3,0,0,0,72
1143532,30,0,6,3,0,0,0,39
1143533,35,0,0,0,0,0,0,35
1143534,66,3,6,0,0,0,0,75
1143535,67,3,3,3,0,0,3,79
1143536,47,5,4,0,0,0,0,56
1143537,60,7,3,0,0,0,4,74
1143538,81,3,3,3,0,0,0,90
1143539,58,0,3,0,0,0,0,61
1143540,44,0,4,0,0,0,0,48
1143541,72,7,3,0,0,0,0,82
1143542,77,4,3,0,0,0,0,84
1143543,10,0,0,0,0,0,0,10
1143544,42,5,0,0,0,0,0,47
1143545,53,5,6,3,0,0,0,67
1143546,63,4,5,4,0,0,3,79
1143547,67,5,0,0,0,0,0,72
1143548,32,6,4,0,0,0,0,42
1143549,48,3,3,0,0,3,0,57
1143550,75,7,4,0,0,0,0,86
1143551,94,10,0,0,0,0,0,104
1143552,74,4,3,3,0,0,0,84
1143553,41,3,0,0,0,0,0,44
1143554,135,13,3,0,0,3,0,154
1143555,25,0,0,0,0,0,0,25
1143556,87,4,6,3,0,0,0,100
1143557,20,3,3,0,0,0,0,26
1143601,25,4,5,4,0,0,0,38
1143602,0,0,0,0,0,0,0,0
1143603,26,3,3,3,0,0,3,38
1143604,30,0,3,0,0,0,3,36
1143605,14,0,3,0,0,0,3,20
1143606,38,3,0,0,0,3,0,44
1143607,106,7,8,0,0,0,3,124
1143608,58,3,0,3,0,0,3,67
1143609,52,3,6,0,0,0,3,64
1143610,34,4,3,0,0,0,0,41
1143611,65,7,3,0,0,0,0,75
1143612,45,4,5,0,0,0,0,54
1143613,51,9,3,0,0,0,0,63
1143614,45,8,0,0,0,0,0,53
1143615,56,3,3,0,0,0,3,65
1143616,53,4,3,3,0,0,0,63
1143617,57,0,0,0,0,0,0,57
1143618,25,7,0,0,0,0,0,32
1143619,54,5,3,3,0,0,0,65
1143620,24,0,3,4,0,0,3,34
1143621,18,4,0,0,0,0,0,22
1143622,29,5,0,0,0,0,0,34
1143623,27,4,0,0,0,0,0,31
1143624,32,4,4,0,0,0,0,40
1143625,39,4,3,3,0,0,3,52
1143626,31,3,3,3,0,0,0,40
1143627,54,3,3,0,0,0,0,60
1143628,29,3,0,3,0,0,0,35
1143629,0,0,0,0,0,0,0,0
1143630,41,3,5,3,0,0,0,52
1143631,47,0,0,5,0,0,0,52
1143632,21,5,6,0,0,0,0,32
1143633,38,8,6,0,0,0,0,52
1143634,48,5,5,3,0,0,3,64
1143635,58,5,3,4,0,3,0,73
1143636,44,4,0,0,0,0,0,48
1143637,59,9,9,4,0,0,0,81
1143638,25,0,4,0,0,0,0,29
1143639,29,0,0,3,0,0,0,32
1143640,67,4,3,0,0,0,0,74
1143641,56,7,5,0,0,0,0,68
1143642,30,3,4,0,0,0,0,37
1143643,37,3,3,3,0,0,0,46
1143644,28,4,3,0,0,0,3,38
1143645,46,4,3,0,0,0,0,53
1143646,64,11,5,0,0,0,0,80
1143701,28,5,0,0,0,0,0,33
1143702,28,0,0,0,0,0,0,28
1143703,50,0,5,0,0,0,0,55
1143704,68,3,4,0,0,0,3,78
1143705,0,0,0,0,0,0,0,0
1143706,53,6,0,0,0,0,0,59
1143707,45,4,0,0,0,0,0,49
1143708,29,3,3,0,0,0,3,38
1143709,0,0,0,0,0,0,0,0
1143710,42,9,5,0,0,0,3,59
1143711,27,0,0,0,0,0,0,27
1143712,21,3,3,0,0,0,0,27
1143713,63,8,3,3,0,0,0,77
1143714,58,8,3,0,0,0,0,69
1143715,37,3,3,0,0,0,3,46
1143716,36,0,3,3,0,0,0,42
1143717,26,3,0,0,0,0,0,29
1143718,33,3,3,0,0,3,0,42
1143719,24,5,6,0,0,0,0,35
1143720,55,4,3,0,0,0,0,62
1143721,79,0,7,0,0,0,0,86
1143722,0,0,0,0,0,0,0,0
1143723,0,0,0,0,0,0,0,0
1143724,51,8,5,0,0,0,0,64
1143725,23,6,0,0,0,0,0,29
1143726,44,3,3,3,0,0,0,53
1143727,38,0,4,0,0,0,0,42
1143728,65,5,8,0,0,0,3,81
1143729,55,3,3,0,0,0,3,64
1143730,51,10,0,3,0,0,0,64
1143731,54,6,4,0,0,3,0,67
1143732,72,0,0,4,0,0,0,76
1143733,61,3,3,3,0,0,0,70
1143734,55,7,4,0,0,0,0,66
1143735,0,0,0,0,0,0,0,0
1143736,25,6,0,0,0,0,0,31
1143737,41,3,3,4,0,0,0,51
1143738,61,4,0,3,0,0,0,68
1143739,91,4,6,0,0,3,0,104
1143801,21,3,3,3,0,0,0,30
1143802,38,0,4,0,0,0,0,42
1143803,55,4,0,0,0,0,0,59
1143804,56,3,3,3,0,0,0,65
1143805,65,4,3,0,0,0,0,72
1143806,51,5,4,3,0,0,0,63
1143807,53,5,3,0,0,0,0,61
1143808,35,5,0,0,0,0,0,40
1143809,69,0,4,0,0,0,0,73
1143810,55,9,3,0,0,0,0,67
1143811,57,4,5,0,0,0,0,66
1143812,56,5,3,0,0,0,0,64
1143813,55,3,3,0,0,0,0,61
1143814,57,0,5,0,0,0,0,62
1143815,44,3,0,0,0,0,0,47
1143816,64,9,3,0,3,0,0,79
1143817,56,3,0,3,0,0,0,62
1143818,51,6,4,0,0,0,0,61
1143819,31,3,4,0,0,0,0,38
1143820,45,7,4,0,0,0,0,56
1143821,55,3,6,0,0,0,0,64
1143822,32,0,0,0,0,0,0,32
1143823,24,4,5,0,0,0,0,33
1143824,57,4,5,0,0,0,0,66
1143825,63,3,3,0,0,0,0,69
1143826,54,0,0,4,0,0,0,58
1143827,67,6,3,3,0,0,0,79
1143828,32,3,6,0,0,0,0,41
1143829,9,0,0,0,0,0,0,9
1143830,49,5,0,0,0,0,0,54
1143831,50,3,0,0,0,0,0,53
1143832,0,0,0,0,0,0,0,0
1143833,37,3,5,0,0,0,3,48
1143834,74,7,0,0,0,0,0,81
1143835,15,0,3,4,0,0,0,22
1143836,68,5,4,0,0,0,0,77
1143837,79,3,3,0,0,0,0,85
1143838,0,0,0,0,0,0,0,0
1143839,14,0,0,4,0,0,0,18
1143840,17,3,4,4,0,0,3,31
1143841,15,7,3,3,0,0,0,28
1143842,68,6,3,0,0,0,0,77
1143843,15,3,0,0,0,0,3,21
1143844,43,3,3,0,0,0,0,49
1143845,17,3,4,0,0,0,0,24
1143846,32,0,3,3,0,0,0,38
1143847,28,0,7,4,3,0,0,42
1143848,31,3,3,3,0,0,0,40
1143849,17,0,0,0,0,3,0,20
1143850,41,4,0,0,0,0,0,45
1143851,79,0,5,0,0,0,0,84
1143852,11,3,3,0,3,0,3,23
1143853,51,4,0,0,0,0,0,55
1143854,0,0,0,0,0,0,0,0
1143855,72,5,0,5,0,0,3,85
1143856,71,6,0,0,0,0,0,77
1143857,27,4,0,0,0,0,0,31
1143858,30,0,0,0,0,0,3,33
1143901,0,0,0,0,0,0,0,0
1144001,27,3,0,0,0,0,0,30
1144002,15,0,0,4,0,0,0,19
1144003,0,0,0,0,0,0,0,0
1144004,135,3,7,0,0,0,0,145
1144005,63,4,0,0,0,0,0,67
1144006,0,0,0,0,0,0,0,0
1144007,25,3,0,0,0,0,0,28
1144008,52,3,0,0,0,0,0,55
1144009,65,3,3,0,0,0,0,71
1144010,46,3,3,0,0,0,0,52
1144011,59,0,5,0,0,0,0,64
1144012,56,0,3,0,0,0,0,59
1144013,75,12,4,0,0,0,0,91
1144014,74,4,4,0,0,0,0,82
1144015,15,6,0,0,0,0,0,21
1144016,43,7,4,0,0,0,0,54
1144017,48,4,0,0,0,0,0,52
1144018,32,10,0,0,0,0,0,42
1144019,43,0,4,0,0,0,0,47
1144020,55,8,0,3,0,0,0,66
1144021,46,3,4,0,0,0,0,53
1144022,36,3,3,3,0,0,3,48
1144023,41,3,3,0,0,0,0,47
1144024,3,0,0,0,0,0,0,3
1144025,53,5,0,0,0,0,0,58
1144026,62,4,3,3,0,0,0,72
1144027,48,0,0,0,0,0,0,48
1144028,46,0,5,0,0,0,0,51
1144029,56,4,3,0,3,0,0,66
1144030,33,5,3,0,0,0,0,41
1144031,56,3,0,3,0,0,0,62
1144032,41,5,0,0,0,0,0,46
1144033,38,3,0,0,0,0,3,44
1144034,40,3,0,5,0,0,0,48
1144035,43,3,3,3,0,0,0,52
1144036,66,9,3,0,0,0,0,78
1144037,71,4,3,0,0,3,0,81
1144038,40,3,0,0,0,0,0,43
1144039,52,5,4,0,0,0,0,61
1144040,55,3,3,0,0,0,0,61
1144041,32,4,0,0,0,0,0,36
1144042,43,4,3,0,0,0,0,50
1144043,36,3,0,0,0,0,0,39
1144044,56,8,0,0,0,0,0,64
1144101,67,3,3,3,0,0,3,79
1144102,44,3,3,0,0,0,0,50
1144103,43,5,3,0,0,0,0,51
1144104,43,0,3,0,0,0,0,46
1144105,39,0,0,0,0,0,0,39
1144106,47,6,4,0,0,0,0,57
1144107,44,3,7,0,0,0,0,54
1144108,67,6,5,0,0,0,0,78
1144109,37,0,0,0,0,0,0,37
1144110,42,4,0,0,0,0,0,46
1144111,52,5,3,4,0,0,0,64
1144112,59,8,0,0,0,0,0,67
1144113,32,3,3,3,0,0,0,41
1144114,72,4,7,0,0,0,0,83
1144115,45,10,3,0,0,0,0,58
1144116,49,0,0,0,0,0,0,49
1144117,45,8,5,3,0,0,0,61
1144118,52,3,3,0,0,0,0,58
1144119,34,7,3,3,0,0,0,47
1144120,49,5,0,3,0,0,0,57
1144121,71,3,0,0,0,0,0,74
1144122,41,5,0,0,0,0,0,46
1144123,23,4,3,4,0,0,4,38
1144124,28,4,0,0,0,0,0,32
1144125,43,0,4,5,0,0,0,52
1144126,45,5,3,3,0,0,0,56
1144127,50,6,6,0,0,0,0,62
1144128,50,7,5,0,0,0,0,62
1144129,48,10,3,3,0,0,3,67
1144130,36,5,4,0,0,0,0,45
1144131,34,3,3,0,0,0,0,40
1144132,55,5,0,3,0,0,3,66
1144133,52,6,8,0,0,0,3,69
1144134,38,3,3,0,3,0,0,47
1144135,67,9,0,0,0,0,0,76
1144136,42,8,3,0,0,0,0,53
1144201,40,0,3,0,0,0,0,43
1144202,158,14,6,0,0,0,0,178
1144203,0,0,0,0,0,0,0,0
1144204,22,3,3,0,3,0,0,31
1144205,33,5,4,0,0,0,3,45
1144206,57,0,3,0,0,0,0,60
1144207,38,0,0,0,0,0,0,38
1144208,0,0,0,0,0,0,0,0
1144209,29,0,0,0,0,0,0,29
1144210,54,4,0,0,0,0,0,58
1144211,51,3,3,0,0,0,0,57
1144212,35,5,3,3,0,0,0,46
1144213,49,0,0,0,0,0,0,49
1144214,43,4,3,0,0,0,0,50
1144215,42,3,0,0,0,0,0,45
1144216,61,3,0,0,0,0,0,64
1144217,29,3,3,0,0,0,0,35
1144218,41,0,0,0,0,0,0,41
1144219,42,3,3,3,0,0,0,51
1144220,62,6,0,0,0,0,0,68
1144221,38,0,0,3,0,0,3,44
1144222,48,3,4,0,0,0,0,55
1144223,77,5,0,0,0,0,0,82
1144224,53,3,4,0,0,0,0,60
1144225,31,0,3,0,0,0,0,34
1144226,37,7,3,0,0,0,0,47
1144227,43,4,4,0,0,0,0,51
1144228,72,3,0,3,0,0,0,78
1144229,33,3,0,0,0,3,0,39
1144230,24,0,0,0,0,0,0,24
1144231,21,9,8,0,0,0,3,41
1144232,24,5,4,0,0,0,0,33
1144233,0,0,0,0,0,0,0,0
1144234,40,5,0,0,0,0,0,45
1144235,62,0,3,3,0,0,0,68
1144236,56,0,5,0,0,0,0,61
1144237,40,0,0,0,0,0,0,40
1144238,29,0,0,0,0,0,0,29
1144239,69,0,4,0,0,0,4,77
1144240,31,3,3,0,0,0,0,37
1144241,57,3,0,0,0,0,0,60
1144242,28,0,3,3,0,0,0,34
1144243,55,6,0,0,0,0,0,61
1144244,49,3,3,0,0,0,0,55
1144245,58,3,0,3,0,3,0,67
1144246,55,3,0,0,0,0,0,58
1144247,45,8,0,0,0,0,0,53
1144248,73,5,3,3,0,0,0,84
1144249,62,3,3,0,0,0,0,68
1144250,47,0,3,3,0,0,0,53
1144251,24,3,0,0,0,0,3,30
1144252,67,0,7,0,0,0,3,77
1144253,29,0,0,0,0,0,0,29
1144301,51,3,3,0,0,0,3,60
1144302,41,8,3,0,0,0,0,52
1144303,40,6,0,0,0,0,0,46
1144304,32,3,3,0,0,0,0,38
1144305,44,3,3,3,0,0,0,53
1144306,75,5,0,0,0,0,0,80
1144307,46,4,3,4,0,0,0,57
1144308,29,5,0,0,0,0,0,34
1144309,71,6,7,0,0,3,0,87
1144310,70,5,0,0,0,0,0,75
1144311,59,0,6,0,0,0,0,65
1144312,0,0,0,0,0,0,0,0
1144313,0,3,0,3,0,0,0,6
1144314,47,0,0,0,0,0,0,47
1144315,39,3,5,3,0,0,0,50
1144316,39,0,3,0,0,3,0,45
1144317,34,5,0,0,0,0,0,39
1144318,66,3,4,0,0,0,0,73
1144319,28,0,4,0,0,0,0,32
1144320,7,0,3,0,0,0,0,10
1144321,24,0,0,3,0,0,0,27
1144322,62,4,5,0,0,0,0,71
1144323,47,0,0,0,0,0,0,47
1144324,54,7,0,0,0,0,0,61
1144325,33,3,3,0,0,0,0,39
1144326,0,0,0,0,0,0,0,0
1144327,58,3,3,3,0,0,0,67
1144328,3,0,0,0,0,3,0,6
1144329,41,4,0,0,0,0,0,45
1144330,52,9,4,0,0,0,0,65
1144331,48,0,3,0,0,3,3,57
1144332,33,3,3,0,0,0,0,39
1144333,43,6,6,0,0,0,0,55
1144334,63,0,5,5,0,0,0,73
1144335,61,4,0,0,0,0,0,65
1144336,44,8,3,0,0,0,0,55
1144337,67,3,5,3,0,0,0,78
1144338,61,4,3,0,0,0,0,68
1144339,51,3,3,0,3,0,0,60
1144340,103,3,3,0,3,0,0,112
1144341,83,3,3,5,0,0,3,97
1144342,0,0,0,0,0,0,0,0
1144343,34,3,0,3,0,0,0,40
1144344,65,0,0,0,0,0,0,65
1144345,26,0,4,0,0,0,3,33
1144346,53,4,3,3,0,0,0,63
1144347,51,3,5,3,0,0,0,62
1144348,50,3,3,0,0,0,0,56
1144349,50,3,0,0,0,0,0,53
1144350,14,3,3,0,0,0,3,23
1144401,4,0,0,0,0,0,3,7
1144402,7,4,0,0,0,0,3,14
1144403,21,5,3,0,0,0,0,29
1144404,18,3,3,3,0,0,0,27
1144405,20,0,0,0,0,0,0,20
1144406,34,0,5,0,0,0,0,39
1144407,44,4,3,3,0,0,0,54
1144408,46,5,0,0,0,0,0,51
1144409,15,0,0,0,0,0,0,15
1144410,64,3,4,0,0,0,0,71
1144411,41,4,3,0,0,0,0,48
1144412,75,8,0,0,0,0,0,83
1144413,79,0,0,0,0,0,0,79
1144414,47,4,7,0,0,0,0,58
1144415,64,3,3,0,0,0,0,70
1144416,57,6,3,0,0,0,0,66
1144417,113,5,3,0,3,0,0,124
1144418,31,0,3,0,0,0,0,34
1144419,33,4,3,0,0,0,0,40
1144420,56,0,5,0,0,0,0,61
1144421,34,3,3,0,0,0,0,40
1144422,43,0,3,3,0,0,0,49
1144423,62,10,6,0,0,0,0,78
1144424,22,4,3,0,0,0,0,29
1144425,67,4,4,0,0,0,0,75
1144426,55,3,3,3,0,0,0,64
1144427,22,3,3,0,0,3,0,31
1144428,48,6,0,0,0,3,0,57
1144429,38,5,3,0,0,0,0,46
1144430,50,3,3,3,0,0,0,59
1144431,23,3,3,0,0,0,0,29
1144432,67,8,3,3,0,0,0,81
1144433,58,3,0,4,0,0,0,65
1144434,57,3,0,0,0,0,0,60
1144435,57,4,0,0,0,0,0,61
1144436,52,0,5,0,0,0,0,57
1144437,50,4,4,0,0,3,0,61
1144438,17,0,0,0,0,0,0,17
1144439,31,3,0,0,0,0,0,34
1144440,35,3,0,0,0,4,0,42
1144441,41,3,4,0,0,0,0,48
1144442,15,0,4,0,0,0,0,19
1144443,7,3,3,0,0,0,0,13
1144444,20,4,0,3,0,0,0,27
1144445,29,0,3,0,0,3,0,35
1144446,44,4,0,0,0,0,0,48
1144447,70,7,8,0,0,3,0,88
1144448,28,0,0,0,0,0,0,28
1144449,34,4,4,0,0,0,0,42
1144450,33,5,4,0,0,0,0,42
1144451,29,4,3,0,0,0,0,36
1144452,57,0,4,0,0,0,0,61
1144453,35,3,0,3,0,0,3,44
1144454,53,6,3,3,0,0,3,68
1144455,40,0,0,3,0,0,0,43
1144456,49,8,0,0,0,0,0,57
1144501,31,0,0,0,0,0,0,31
1144502,11,0,0,0,0,0,0,11
1144503,86,6,3,0,0,0,0,95
1144504,36,4,4,0,0,0,0,44
1144505,55,0,0,3,0,0,0,58
1144506,72,11,0,0,0,0,0,83
1144507,29,3,3,0,0,0,0,35
1144508,13,3,0,0,0,0,0,16
1144509,31,3,4,0,0,0,0,38
1144510,55,3,3,3,0,0,0,64
1144511,46,6,4,3,0,0,0,59
1144512,70,3,3,3,0,0,0,79
1144513,40,6,3,0,0,0,0,49
1144514,26,3,3,3,0,0,0,35
1144515,51,3,3,0,0,0,0,57
1144601,63,0,5,0,0,0,0,68
1144602,45,6,3,0,0,0,0,54
1144603,51,3,3,0,0,0,3,60
1144604,78,5,0,0,0,0,0,83
1144605,45,3,3,0,0,0,0,51
1144606,84,10,8,0,0,0,0,102
1144607,37,4,0,0,0,0,0,41
1144608,39,3,3,0,0,0,0,45
1144609,55,3,3,0,0,0,0,61
1144610,34,3,3,0,0,0,0,40
1144611,36,0,0,5,0,0,0,41
1144612,42,6,5,3,0,3,0,59
1144613,38,0,0,3,0,0,0,41
1144614,91,4,4,0,0,0,0,99
1144615,55,3,8,0,0,0,0,66
1144616,26,3,3,0,0,0,3,35
1144617,38,5,7,0,0,0,0,50
1144618,29,3,3,0,0,0,0,35
1144619,45,4,0,0,0,0,0,49
1144701,32,3,0,0,0,0,0,35
1144702,23,3,0,0,0,0,0,26
1144703,19,4,4,0,0,0,0,27
1144704,43,5,3,0,0,0,0,51
1144705,66,5,8,0,0,0,0,79
1144706,21,7,0,0,0,0,0,28
1144707,66,0,5,0,0,3,0,74
1144708,28,0,3,0,0,0,3,34
1144709,42,0,4,5,0,0,0,51
1144710,23,3,0,0,0,0,0,26
1144711,33,3,0,0,0,0,0,36
1144712,21,5,4,0,0,0,0,30
1144713,49,3,3,3,0,3,0,61
1144714,62,6,0,0,0,0,0,68
1144715,70,4,6,0,0,0,3,83
1144716,12,0,0,0,0,0,0,12
1144717,42,3,0,0,0,0,0,45
1144718,36,0,3,0,0,0,3,42
1144719,22,6,0,0,0,0,0,28
1144720,51,6,3,0,0,0,0,60
1144721,27,4,4,0,0,0,0,35
1144722,54,4,6,3,0,0,0,67
1144723,67,6,3,0,0,0,0,76
1144724,50,4,0,0,0,0,0,54
1144725,26,3,0,0,0,0,0,29
1144726,65,6,3,0,0,0,0,74
1144727,28,6,3,0,0,0,0,37
1144728,39,4,3,0,0,0,3,49
1144729,45,3,0,0,0,0,0,48
1144730,60,10,3,0,0,0,0,73
1144731,30,4,3,4,0,0,0,41
1144732,0,0,0,0,0,0,0,0
1144733,38,3,0,0,0,0,0,41
1144734,41,5,3,3,0,0,0,52
1144735,53,3,3,0,0,0,0,59
1144736,49,5,4,0,0,0,0,58
1144737,84,4,4,0,0,0,0,92
1144738,36,5,4,0,0,0,0,45
1144739,38,3,4,0,0,0,3,48
1144740,41,3,4,3,0,0,0,51
1144741,35,3,0,0,0,0,0,38
1144742,38,0,4,5,0,0,0,47
1144743,16,0,3,0,0,0,0,19
1144801,46,6,0,0,0,0,0,52
1144802,47,0,0,0,0,0,0,47
1144803,42,3,0,3,0,0,0,48
1144804,24,0,0,0,0,0,0,24
1144805,68,8,6,3,0,0,3,88
1144806,30,0,0,0,0,0,0,30
1144807,31,4,0,0,0,0,0,35
1144808,29,3,6,0,0,0,0,38
1144809,59,0,0,3,0,0,3,65
1144810,78,3,0,0,0,0,0,81
1144811,78,5,3,3,0,3,0,92
1144812,23,0,3,0,0,0,0,26
1144813,39,3,0,0,0,0,0,42
1144814,76,7,0,0,0,0,0,83
1144815,34,3,3,0,0,0,0,40
1144816,42,4,0,0,0,0,3,49
1144817,49,0,3,0,0,0,0,52
1144818,38,0,0,0,0,3,0,41
1144819,41,4,0,3,0,0,0,48
1144820,39,5,6,0,0,0,0,50
1144821,43,3,10,0,0,3,0,59
1144822,41,3,4,0,0,0,0,48
1144823,49,4,0,0,0,0,0,53
1144824,40,0,0,4,0,0,0,44
1144901,21,0,0,0,0,0,0,21
1144902,16,3,0,3,0,0,0,22
1144903,17,0,3,0,0,0,0,20
1144904,19,0,3,0,0,0,0,22
1144905,38,0,3,0,0,0,0,41
1144906,23,0,0,0,0,0,0,23
1144907,38,6,0,4,0,0,0,48
1144908,4,0,0,0,0,0,0,4
1144909,26,0,5,0,0,0,0,31
1144910,38,7,3,0,0,0,3,51
1144911,18,6,0,0,0,0,0,24
1144912,37,0,0,0,0,0,0,37
1144913,30,3,3,0,0,0,0,36
1144914,18,0,0,0,0,0,0,18
1144915,27,4,0,0,0,0,0,31
1145001,26,4,3,0,0,0,0,33
1145002,14,0,0,0,0,0,0,14
1145003,58,3,0,0,0,0,0,61
1145004,30,3,3,0,0,0,0,36
1145005,57,8,3,0,0,0,0,68
1145006,27,0,0,0,0,0,0,27
1145007,31,3,0,0,0,0,0,34
1145008,43,3,3,0,0,0,3,52
1145009,76,3,5,0,0,0,0,84
1145010,63,0,0,0,0,0,0,63
1145011,47,3,3,0,0,0,3,56
1145012,71,4,6,0,0,0,3,84
1145013,26,0,3,0,0,0,0,29
1145014,24,3,3,0,0,0,0,30
1145015,50,0,0,0,0,0,0,50
1145016,49,0,0,0,0,0,0,49
1145017,58,5,0,0,0,0,0,63
1145018,47,0,3,3,0,0,0,53
1145019,68,7,0,0,0,0,0,75
1145020,44,0,0,0,0,0,0,44
1145021,0,0,0,0,0,0,0,0
1145022,51,3,3,0,0,0,0,57
1145023,64,5,3,0,0,0,0,72
1145024,55,0,5,0,0,0,3,63
1145025,57,11,0,3,0,0,0,71
1145026,36,6,0,0,0,0,0,42
1145027,88,7,0,0,0,0,0,95
1145028,36,0,0,0,0,0,0,36
1145029,75,6,0,0,0,0,0,81
1145030,61,6,3,0,0,0,0,70
1145031,69,0,3,0,0,0,0,72
1145032,43,3,3,0,0,0,0,49
1145033,76,4,3,0,0,0,0,83
1145034,42,4,3,3,0,0,0,52
1145035,0,0,0,0,0,0,0,0
1145036,55,3,0,0,0,0,0,58
1145037,60,6,3,0,0,0,0,69
1145038,71,3,3,0,0,0,0,77
1145039,0,0,0,0,0,0,0,0
1145040,38,4,0,0,0,0,0,42
1145041,78,3,3,0,0,0,0,84
1145042,49,3,3,0,0,0,0,55
1145043,50,4,3,0,0,0,0,57
1145044,65,0,3,0,0,0,0,68
1145045,60,8,3,0,0,0,0,71
1145046,45,6,0,0,0,0,0,51
1145047,37,0,0,0,0,0,0,37
1145048,65,8,0,0,0,0,0,73
1145049,40,5,5,0,0,0,0,50
1145050,26,3,0,0,0,0,0,29
1145051,41,0,3,0,0,0,0,44
1145101,3,0,0,0,0,0,0,3
1145201,14,3,0,0,0,0,0,17
1145202,46,10,3,0,0,0,0,59
1145203,28,7,5,0,0,0,0,40
1145204,23,3,3,3,0,0,0,32
1145205,25,4,0,0,0,0,0,29
1145206,12,3,3,0,0,0,0,18
1145207,29,6,0,0,0,0,0,35
1145208,38,3,4,0,0,0,0,45
1145209,21,4,0,0,0,0,0,25
1145210,19,0,0,0,0,0,0,19
1145211,17,3,0,0,0,0,0,20
1145212,39,5,0,0,0,0,0,44
1145213,20,6,3,0,0,0,0,29
1145214,14,3,0,0,0,0,0,17
1145215,0,0,0,0,0,0,0,0
1145216,34,0,4,0,0,0,0,38
1145217,24,0,0,0,0,0,0,24
1145218,24,3,3,0,0,0,0,30
1145219,30,3,5,0,0,0,0,38
1145220,19,3,0,0,0,0,0,22
1145221,26,0,0,0,0,0,0,26
1145222,0,0,0,0,0,0,0,0
1145223,54,4,5,0,0,0,0,63
1145224,30,0,4,0,0,0,0,34
1145225,18,0,0,0,0,0,0,18
1145226,13,0,0,0,0,0,0,13
1145227,20,0,0,0,0,0,0,20
1145228,27,3,0,0,0,0,3,33
1145229,16,3,0,3,0,0,0,22
1145230,18,3,0,0,0,0,0,21
1145231,16,5,0,0,0,0,0,21
1145232,44,4,3,3,0,0,0,54
1145233,36,3,3,0,0,0,0,42
1145234,28,3,0,0,0,0,0,31
1145235,22,3,3,0,0,0,0,28
1145236,23,0,0,0,0,0,0,23
1145237,6,0,0,0,0,0,0,6
1145301,3,0,0,0,0,0,0,3
1145302,44,3,3,0,0,0,0,50
1145303,39,5,4,0,0,0,3,51
1145304,28,0,0,0,0,0,0,28
1145305,62,9,0,0,0,0,0,71
1145306,42,7,3,0,0,0,0,52
1145307,66,4,0,0,0,0,0,70
1145308,32,4,0,0,0,0,0,36
1145309,43,3,3,0,0,0,3,52
1145310,62,3,3,0,0,0,3,71
1145311,55,4,10,0,0,0,0,69
1145312,55,3,0,0,0,0,0,58
1145313,37,4,0,0,0,0,0,41
1145314,30,3,0,0,0,0,0,33
1145315,39,4,0,0,0,0,0,43
1145316,53,3,5,0,0,0,0,61
1145317,0,0,0,0,0,0,0,0
1145318,52,10,4,0,0,0,3,69
1145319,51,7,3,0,0,0,0,61
1145320,56,5,3,0,0,0,0,64
1145321,68,6,3,0,0,0,0,77
1145322,39,0,0,0,0,0,0,39
1145323,29,3,0,0,0,0,0,32
1145324,53,4,4,0,0,0,0,61
1145325,28,0,5,0,0,0,0,33
1145326,59,0,5,0,3,0,0,67
1145327,59,3,6,0,0,0,0,68
1145328,43,3,0,0,0,0,0,46
1145401,55,3,3,0,0,0,0,61
1145402,58,3,4,0,0,0,0,65
1145403,41,0,0,0,0,0,0,41
1145404,68,3,4,0,0,0,0,75
1145405,80,7,0,0,0,0,0,87
1145406,61,4,3,0,0,0,0,68
1145407,82,5,5,0,0,0,0,92
1145408,50,3,3,0,0,0,3,59
1145409,78,7,4,0,0,0,3,92
1145410,37,6,0,0,0,0,0,43
1145411,71,10,5,0,0,0,0,86
1145412,69,3,6,3,0,0,0,81
1145413,38,7,0,0,0,0,0,45
1145414,24,0,3,4,0,0,0,31
1145415,32,7,0,0,0,0,0,39
1145416,44,0,0,3,0,0,3,50
1145417,34,7,5,0,0,0,0,46
1145418,63,3,3,3,0,0,0,72
1145419,46,6,4,0,0,0,4,60
1145420,37,3,5,0,0,0,0,45
1145421,52,7,0,0,0,0,0,59
1145422,57,4,0,0,0,0,0,61
1145423,53,6,0,0,0,0,0,59
1145424,64,9,3,0,0,0,0,76
1145425,25,0,0,0,0,0,0,25
1145426,50,6,0,0,0,0,0,56
1145427,41,3,0,3,0,0,0,47
1145428,37,4,3,0,0,0,0,44
1145429,28,3,6,0,0,0,0,37
1145430,75,5,3,0,0,0,0,83
1145431,48,5,4,0,0,0,0,57
1145432,56,6,3,0,0,0,0,65
1145433,84,9,6,0,0,0,0,99
1145434,8,0,3,0,0,0,0,11
1145435,58,4,0,3,0,0,0,65
1145436,48,6,3,0,0,0,0,57
1145437,93,8,0,0,0,0,0,101
1145438,50,3,3,0,0,0,0,56
1145439,34,0,3,0,0,0,0,37
1145440,62,4,3,0,0,0,0,69
1145441,44,8,0,0,0,0,0,52
1145442,43,3,0,0,0,0,0,46
1145443,22,0,5,0,0,0,0,27
1145444,46,6,3,0,0,0,0,55
1145445,59,5,0,0,0,0,0,64
1145446,52,6,4,0,0,0,0,62
1145447,84,11,3,0,0,0,0,98
1145448,49,0,4,0,0,0,0,53
1145449,32,4,0,0,0,0,0,36
1145450,68,0,5,0,0,0,0,73
1145451,18,3,0,0,0,0,0,21
1145501,35,0,0,0,0,0,0,35
1145502,22,3,0,0,0,0,0,25
1145503,49,7,0,0,0,0,0,56
1145504,34,0,3,0,0,3,0,40
1145505,39,3,3,0,0,0,3,48
1145506,47,3,3,0,0,0,0,53
1145507,42,0,3,0,0,0,0,45
1145508,33,0,0,0,0,0,0,33
1145509,30,3,3,3,0,0,3,42
1145510,20,4,0,0,0,0,0,24
1145511,35,4,0,0,0,0,0,39
1145512,30,0,0,0,0,0,0,30
1145513,31,6,0,0,0,0,0,37
1145514,42,3,4,0,0,0,0,49
1145515,23,4,3,0,0,0,0,30
1145601,0,0,0,0,0,0,0,0
1145701,37,6,3,0,0,0,0,46
1145702,67,4,7,0,0,0,0,78
1145703,64,0,4,0,0,0,0,68
1145704,45,3,4,0,0,0,0,52
1145705,45,3,3,4,0,0,0,55
1145706,18,3,3,0,0,0,0,24
1145707,27,3,3,0,0,0,0,33
1145708,28,0,4,0,0,0,0,32
1145709,36,4,0,4,0,0,0,44
1145710,33,4,0,0,0,0,0,37
1145711,64,5,3,0,0,0,0,72
1145712,62,10,6,0,0,0,0,78
1145713,50,3,0,0,0,0,0,53
1145714,22,3,4,0,0,0,0,29
1145715,66,6,3,0,0,0,0,75
1145716,40,3,0,0,0,0,0,43
1145717,52,3,8,0,0,0,0,63
1145718,37,8,5,0,0,0,3,53
1145719,31,0,0,0,0,0,0,31
1145720,34,0,3,0,0,0,3,40
1145721,68,8,3,4,0,0,0,83
1145722,27,7,3,0,0,0,0,37
1145723,50,4,0,0,0,0,0,54
1145724,50,3,4,0,0,0,0,57
1145725,49,4,3,0,0,0,0,56
1145726,31,0,0,0,0,0,0,31
1145727,32,0,3,0,0,0,0,35
1145728,28,4,0,0,0,0,0,32
1145729,40,4,3,0,0,0,0,47
1145730,46,4,3,0,0,0,0,53
1145731,35,0,4,0,0,0,0,39
1145732,56,6,4,0,0,0,0,66
1145733,51,8,4,0,0,0,0,63
1145734,65,0,6,0,0,3,0,74
1145735,31,6,0,0,0,0,0,37
1145736,31,4,3,0,0,0,0,38
1145737,68,0,0,0,0,0,0,68
1145738,45,0,4,0,0,0,0,49
1145739,36,5,5,0,0,0,0,46
1145740,52,16,3,0,0,0,0,71
1145741,37,3,0,0,0,0,0,40
1145801,56,3,3,0,0,0,3,65
1145802,47,4,6,4,0,0,0,61
1145803,34,5,0,0,0,0,5,44
1145804,37,0,0,0,0,0,0,37
1145805,36,4,0,0,0,0,0,40
1145806,48,4,3,3,0,0,3,61
1145807,65,3,0,0,0,0,4,72
1145808,67,6,0,0,0,0,0,73
1145809,50,3,5,0,0,0,4,62
1145810,54,7,0,0,0,0,0,61
1145811,34,3,3,0,0,0,0,40
1145812,49,4,0,4,0,0,0,57
1145813,71,3,3,0,0,0,0,77
1145814,51,3,3,3,0,0,0,60
1145815,57,0,3,0,0,0,0,60
1145816,33,4,0,0,0,0,3,40
1145817,30,0,3,0,0,0,0,33
1145818,45,3,0,0,0,0,0,48
1145819,39,9,0,0,0,0,0,48
1145820,61,9,3,0,0,0,0,73
1145821,29,4,3,0,0,0,0,36
1145822,64,3,3,3,0,0,3,76
1145823,37,0,0,0,0,0,0,37
1145824,31,3,0,0,0,3,0,37
1145825,0,0,0,0,0,0,0,0
1145826,53,6,3,3,0,0,0,65
1145827,29,3,0,0,0,0,0,32
1145828,48,7,3,0,0,0,0,58
1145829,60,5,3,0,3,0,0,71
1145830,62,4,6,3,0,0,0,75
1145831,52,6,0,0,0,0,0,58
1145832,31,7,0,0,0,0,0,38
1145833,9,3,3,3,0,0,0,18
1145834,21,6,3,0,0,0,0,30
1145835,32,6,5,0,0,0,0,43
1145836,27,7,3,0,0,0,0,37
1145837,55,10,5,0,0,0,0,70
1145838,57,4,3,0,0,0,3,67
1145839,33,4,3,0,0,0,0,40
1145840,39,3,0,3,0,0,3,48
1145841,67,4,6,0,0,0,0,77
1145842,70,7,0,3,0,0,0,80
1145843,22,3,7,3,0,0,3,38
1145844,48,0,0,0,3,0,0,51
1145845,31,3,3,0,0,0,0,37
1145846,59,3,3,0,0,0,0,65
1145847,31,0,3,0,0,0,0,34
1145848,0,0,0,0,0,0,0,0
1145849,52,3,3,3,0,0,0,61
1145901,36,3,4,0,0,0,4,47
1145902,62,4,3,0,0,0,3,72
1145903,31,4,3,0,0,0,0,38
1145904,53,6,0,0,0,0,0,59
1145905,41,4,5,0,0,0,0,50
1145906,73,0,6,4,0,0,0,83
1145907,54,4,0,0,0,0,0,58
1145908,31,4,0,0,0,0,0,35
1145909,34,3,3,3,0,0,0,43
1145910,61,3,7,0,0,0,3,74
1145911,30,3,0,0,0,0,0,33
1145912,40,4,5,0,0,0,0,49
1145913,76,5,0,4,0,0,0,85
1145914,32,6,3,3,0,0,0,44
1145915,76,7,4,0,0,0,0,87
1145916,35,3,0,0,0,0,0,38
1145917,74,0,0,4,0,0,0,78
1145918,53,3,5,0,0,0,0,61
1145919,33,0,0,0,0,0,0,33
1145920,38,8,0,0,0,0,0,46
1145921,38,3,0,0,0,0,0,41
1145922,53,4,3,0,0,0,0,60
1145923,56,4,0,0,0,0,0,60
1145924,49,5,3,0,0,0,0,57
1145925,41,4,4,0,0,0,0,49
1145926,40,5,8,0,0,0,0,53
1145927,65,5,0,0,0,0,0,70
1145928,60,5,0,0,0,0,0,65
1145929,38,5,8,4,0,0,0,55
1145930,46,3,3,0,0,0,0,52
1145931,48,6,5,0,0,0,0,59
1145932,0,0,0,0,0,0,0,0
1145933,74,8,3,0,0,0,0,85
1145934,60,0,0,3,0,0,0,63
1146001,42,6,7,0,0,0,0,55
1146002,62,5,0,0,0,0,0,67
1146003,47,6,0,0,0,0,0,53
1146004,38,3,0,0,0,0,0,41
1146005,65,0,8,0,0,0,0,73
1146006,35,0,4,0,0,0,0,39
1146007,41,3,0,0,0,3,0,47
1146008,75,7,0,0,0,0,0,82
1146009,55,5,3,0,0,0,0,63
1146010,68,6,5,0,0,0,0,79
1146011,43,8,3,0,0,0,0,54
1146012,93,13,9,0,0,0,0,115
1146013,49,11,4,3,0,0,0,67
1146014,80,5,3,0,0,0,3,91
1146015,85,11,0,0,0,0,0,96
1146016,59,10,3,0,0,0,0,72
1146017,0,0,0,0,0,0,0,0
1146018,84,8,3,0,0,0,0,95
1146019,83,3,3,0,0,3,0,92
1146020,44,5,3,0,0,0,0,52
1146021,68,3,3,0,0,3,0,77
1146022,60,8,3,0,0,0,0,71
1146023,52,0,3,0,0,0,0,55
1146024,93,8,0,0,0,0,0,101
1146025,38,3,4,0,0,3,0,48
1146026,55,3,0,0,3,0,0,61
1146027,91,4,4,0,0,0,0,99
1146028,74,4,7,0,0,0,0,85
1146029,55,0,3,0,0,0,0,58
1146030,41,6,4,0,0,0,0,51
1146031,80,4,4,0,0,0,0,88
1146032,34,0,5,0,0,0,0,39
1146033,56,5,3,0,0,0,3,67
1146034,62,3,4,3,0,0,0,72
1146035,122,5,4,0,0,0,0,131
1146036,73,4,0,0,0,0,0,77
1146037,31,0,5,4,0,0,0,40
1146038,51,4,6,0,0,0,0,61
1146039,58,5,5,0,0,0,0,68
1146040,59,4,0,0,0,0,0,63
1146041,75,0,0,5,0,0,0,80
1146042,82,8,5,4,0,0,0,99
1146043,93,12,5,0,0,0,0,110
1146044,79,6,5,0,0,0,0,90
1146045,47,7,8,0,0,0,0,62
1146046,28,4,3,0,0,0,0,35
1146047,100,5,0,3,0,0,0,108
1146048,77,6,3,4,0,0,0,90
1146049,69,3,3,0,0,0,0,75
1146101,28,0,3,3,0,0,3,37
1146102,37,0,0,3,0,0,3,43
1146103,76,0,5,0,0,0,0,81
1146104,47,0,0,0,0,0,0,47
1146105,49,4,4,0,0,0,0,57
1146106,84,3,6,3,0,0,0,96
1146107,36,3,7,0,0,0,0,46
1146108,29,0,3,3,0,0,0,35
1146109,45,10,0,0,3,0,0,58
1146110,53,7,3,0,0,0,0,63
1146111,31,7,4,0,0,0,0,42
1146112,70,5,3,3,0,0,0,81
1146113,26,6,3,0,0,0,0,35
1146114,35,4,3,3,0,0,0,45
1146115,40,5,0,0,0,0,0,45
1146116,48,12,3,0,0,0,0,63
1146117,76,7,3,0,0,0,0,86
1146118,51,3,6,0,0,0,0,60
1146119,56,5,5,0,0,0,0,66
1146120,74,5,8,3,0,0,0,90
1146121,68,4,3,0,0,0,0,75
1146122,18,7,0,0,0,0,0,25
1146123,45,4,4,0,0,0,0,53
1146124,39,6,0,0,0,0,0,45
1146125,34,3,3,0,0,0,0,40
1146126,57,0,0,0,0,0,0,57
1146127,65,8,0,0,0,0,3,76
1146128,34,3,3,0,0,0,0,40
1146129,43,4,0,0,0,0,0,47
1146130,52,5,0,0,0,0,0,57
1146131,55,8,0,0,0,0,3,66
1146132,30,3,3,0,0,0,0,36
1146133,0,0,0,0,0,0,0,0
1146134,37,4,3,0,0,0,0,44
1146135,16,3,3,0,0,0,0,22
1146136,21,0,4,0,0,0,0,25
1146137,25,3,0,3,0,0,0,31
1146138,39,3,5,0,0,0,0,47
1146139,68,4,4,4,0,0,0,80
1146140,6,0,0,0,0,0,3,9
1146141,49,5,6,3,0,0,0,63
1146201,48,4,3,0,0,0,0,55
1146202,26,4,0,0,0,0,4,34
1146203,24,3,4,0,0,0,0,31
1146204,41,8,4,0,0,0,0,53
1146205,58,7,0,3,0,0,0,68
1146206,32,4,7,0,0,0,0,43
1146207,59,3,3,0,0,0,3,68
1146208,39,0,0,0,0,0,0,39
1146209,33,3,6,3,0,0,0,45
1146210,12,5,0,0,0,0,0,17
1146211,4,0,0,0,0,0,0,4
1146212,20,0,0,0,0,0,0,20
1146213,41,3,3,0,0,0,3,50
1146214,29,6,4,0,0,3,0,42
1146215,0,0,0,0,0,0,0,0
1146216,61,4,4,0,0,0,0,69
1146217,39,5,3,0,0,0,0,47
1146218,18,3,0,3,0,0,0,24
1146219,44,7,3,0,0,0,0,54
1146220,41,5,7,0,0,0,0,53
1146221,42,0,0,0,0,0,0,42
1146222,111,12,3,5,0,0,0,131
1146223,45,3,3,0,0,0,0,51
1146224,64,5,6,0,0,0,0,75
1146225,50,13,3,0,0,0,0,66
1146226,20,3,0,0,0,0,0,23
1146227,23,4,3,0,0,0,0,30
1146228,50,6,7,0,3,0,0,66
1146229,73,8,3,0,0,3,0,87
1146230,34,3,3,0,0,0,0,40
1146231,76,3,3,3,0,0,0,85
1146232,27,3,4,0,0,0,0,34
1146233,76,3,0,0,0,0,0,79
1146234,49,3,3,0,0,0,0,55
1146235,71,9,0,0,0,0,0,80
1146236,89,6,3,0,0,0,0,98
1146237,31,3,0,0,0,0,0,34
1146238,37,3,3,0,0,0,0,43
1146239,70,6,3,0,0,0,0,79
1146301,19,0,0,0,0,0,0,19
1146302,33,0,0,0,0,4,0,37
1146303,51,4,3,0,0,0,0,58
1146304,34,0,0,6,0,0,0,40
1146305,47,0,3,3,0,0,0,53
1146306,42,3,4,0,0,0,0,49
1146307,57,4,8,0,0,0,0,69
1146308,79,4,8,0,0,0,0,91
1146309,49,7,0,0,0,0,0,56
1146310,62,5,0,0,0,0,0,67
1146311,24,3,0,0,3,0,0,30
1146312,67,3,3,0,0,0,3,76
1146313,39,0,3,0,0,0,0,42
1146314,34,3,3,0,0,0,0,40
1146315,73,3,3,0,0,0,0,79
1146316,25,4,0,0,0,0,0,29
1146317,23,4,0,0,0,0,4,31
1146318,31,4,0,0,0,0,0,35
1146319,33,0,0,0,0,0,0,33
1146401,29,5,0,0,0,0,0,34
1146402,19,4,0,0,0,0,0,23
1146403,30,3,0,3,0,0,0,36
1146404,17,6,0,0,0,0,0,23
1146405,30,3,3,0,0,0,0,36
1146406,10,0,0,0,0,0,0,10
1146407,56,3,0,0,0,0,0,59
1146408,81,6,10,0,0,0,0,97
1146409,34,4,4,0,0,0,0,42
1146410,13,3,3,0,0,0,0,19
1146411,42,3,4,0,0,0,0,49
1146412,22,0,0,0,0,0,0,22
1146413,24,5,0,0,0,0,0,29
1146414,26,5,0,0,0,0,0,31
1146415,20,8,0,0,0,0,0,28
1146416,12,0,0,0,0,0,0,12
1146417,10,3,3,0,0,0,0,16
1146418,39,3,3,0,0,0,0,45
1146419,31,0,0,0,0,0,0,31
1146420,19,8,0,4,0,0,0,31
1146421,36,3,3,4,0,0,0,46
1146422,18,4,3,0,0,0,0,25
1146423,16,0,0,0,0,0,0,16
1146424,3,0,0,0,0,0,0,3
1146425,13,3,3,0,0,0,0,19
1146426,0,0,0,0,0,0,0,0
1146427,0,0,0,0,0,0,0,0
1146428,0,0,0,0,0,0,0,0
1146429,30,4,3,3,0,0,0,40
1146430,66,3,3,3,0,0,0,75
1146431,49,6,6,0,0,0,0,61
1146432,26,0,3,3,0,0,0,32
1146433,19,3,0,0,0,0,0,22
1146501,80,9,3,3,0,0,0,95
1146502,0,0,0,0,0,0,0,0
1146503,0,0,0,0,0,0,0,0
1146504,99,5,3,0,0,0,3,110
1146505,57,4,4,0,0,0,0,65
1146506,105,11,3,0,3,0,0,122
1146507,59,0,6,0,0,0,0,65
1146508,44,3,3,0,0,0,0,50
1146509,35,4,0,0,0,0,0,39
1146510,41,0,4,0,0,0,0,45
1146511,49,4,0,0,0,0,0,53
1146512,30,5,0,0,0,0,3,38
1146513,47,3,0,0,0,0,0,50
1146514,45,4,3,3,0,0,0,55
1146601,67,5,0,0,0,0,0,72
1146602,21,0,3,0,0,0,0,24
1146603,46,3,3,0,0,0,0,52
1146604,59,3,7,0,0,0,0,69
1146605,44,5,6,0,0,3,0,58
1146606,0,0,0,0,0,0,0,0
1146607,16,0,0,0,0,0,0,16
1146608,22,4,3,0,0,0,0,29
1146609,36,8,0,0,0,0,0,44
1146610,12,5,0,0,0,0,0,17
1146611,51,0,3,0,0,0,0,54
1146612,52,12,0,0,0,0,0,64
1146613,63,6,0,0,0,0,0,69
1146614,48,3,0,0,0,0,0,51
1146615,52,8,0,0,0,0,0,60
1146616,47,6,3,0,0,0,0,56
1146617,58,7,6,0,0,0,0,71
1146618,4,0,0,0,0,0,0,4
1146619,15,3,3,0,0,0,0,21
1146620,44,6,0,0,0,0,4,54
1146621,23,3,0,0,0,0,0,26
1146622,41,3,7,0,0,0,0,51
1146623,25,3,4,0,0,3,0,35
1146624,9,0,0,0,0,0,0,9
1146625,44,3,3,0,0,0,0,50
1146626,39,4,3,0,0,0,0,46
1146627,69,10,5,0,0,0,0,84
1146628,33,5,0,0,0,0,3,41
1146629,35,8,4,3,0,0,0,50
1146630,21,6,5,0,0,0,0,32
1146631,30,3,3,0,0,0,3,39
1146632,23,3,0,0,0,0,0,26
1146633,41,3,5,0,0,0,0,49
1146701,4,0,0,0,0,0,0,4
1146702,41,8,3,0,0,0,0,52
1146703,14,0,0,0,0,0,0,14
1146704,16,3,0,0,0,0,0,19
1146705,0,0,0,0,0,0,0,0
1146706,0,0,0,0,0,0,0,0
1146707,53,8,0,3,0,0,0,64
1146708,0,0,0,0,0,0,0,0
1146709,21,0,3,0,0,0,0,24
1146710,28,13,3,0,0,0,0,44
1146711,27,3,0,0,0,0,0,30
1146712,24,3,5,0,0,0,0,32
1146713,39,0,0,0,0,0,0,39
1146714,35,0,5,0,0,0,0,40
1146715,65,7,7,0,0,0,0,79
1146716,49,3,6,0,0,0,0,58
1146717,19,0,0,0,0,0,0,19
1146718,51,4,8,0,0,0,0,63
1146719,25,3,3,3,0,0,0,34
1146720,24,4,0,0,0,0,0,28
1146721,28,4,6,0,0,0,0,38
1146722,37,6,4,0,0,0,0,47
1146723,27,0,3,0,0,0,0,30
1146724,28,5,0,3,0,0,0,36
1146725,36,3,3,0,0,0,0,42
1146726,37,4,4,0,0,0,0,45
1146727,32,3,3,0,0,0,0,38
1146728,26,10,0,0,0,0,0,36
1146729,14,3,3,0,0,0,0,20
1146730,89,3,9,0,0,0,0,101
1146731,69,3,6,0,0,0,0,78
1146732,44,4,3,0,0,0,3,54
1146733,44,3,3,0,0,0,0,50
1146734,12,4,0,0,0,0,0,16
1146735,52,5,0,0,0,0,0,57
1146736,53,3,6,0,0,0,0,62
1146737,60,11,0,0,0,0,0,71
1146738,46,8,3,0,0,0,0,57
1146739,67,4,5,0,3,0,0,79
1146740,39,5,10,0,0,0,0,54
1146741,72,8,9,0,0,0,0,89
1146742,42,4,4,0,0,0,0,50
1146743,39,4,0,0,0,0,0,43
1146744,59,7,10,0,0,0,0,76
1146745,43,0,6,0,0,0,0,49
1146801,59,5,3,0,0,0,0,67
1146802,71,5,4,0,0,0,3,83
1146803,70,3,3,0,3,0,0,79
1146804,31,0,3,0,0,0,0,34
1146805,42,6,0,0,0,0,0,48
1146806,27,0,4,0,0,0,0,31
1146807,40,6,3,3,0,0,3,55
1146808,0,0,0,0,0,0,0,0
1146809,0,0,0,0,0,0,0,0
1146810,34,0,3,3,0,0,0,40
1146811,46,3,3,3,0,0,0,55
1146812,26,0,5,0,0,0,0,31
1146813,37,0,3,3,0,0,0,43
1146814,33,3,0,3,0,0,0,39
1146815,52,4,3,0,0,0,0,59
1146816,57,4,4,0,0,0,0,65
1146817,47,3,3,3,0,0,0,56
1146818,79,3,3,0,0,0,0,85
1146819,54,8,4,0,0,0,0,66
1146901,66,4,4,0,0,0,3,77
1146902,57,3,3,0,0,0,0,63
1146903,36,3,8,3,0,0,0,50
1146904,41,3,3,0,0,0,0,47
1146905,50,3,3,0,0,0,0,56
1146906,75,4,3,3,0,0,0,85
1146907,0,0,0,0,0,0,0,0
1146908,0,0,0,0,0,0,0,0
1146909,79,4,6,0,0,0,0,89
1146910,27,4,0,0,0,0,0,31
1146911,73,11,4,5,0,0,0,93
1146912,44,4,3,0,0,0,0,51
1146913,53,4,0,0,0,0,0,57
1146914,32,3,3,0,0,0,0,38
1146915,68,8,3,0,0,0,0,79
1146916,63,3,8,0,0,0,0,74
1146917,35,0,0,0,0,0,0,35
1146918,72,3,0,0,0,0,0,75
1146919,57,0,4,0,3,0,5,69
1146920,60,7,3,0,0,3,0,73
1147001,47,7,0,0,0,0,0,54
1147002,54,8,4,0,0,0,0,66
1147003,88,0,0,0,0,3,0,91
1147004,47,3,0,0,0,0,0,50
1147005,91,3,4,0,3,0,3,104
1147006,90,0,4,4,0,0,0,98
1147007,94,4,8,0,0,0,0,106
1147008,55,6,4,0,0,0,0,65
1147009,44,3,3,0,0,0,0,50
1147010,81,11,5,3,0,0,0,100
1147011,64,3,3,0,0,0,0,70
1147012,63,0,4,5,0,0,0,72
1147013,88,5,3,0,0,0,0,96
1147014,34,9,0,0,0,0,0,43
1147015,66,3,5,0,0,0,0,74
1147016,64,7,0,0,0,0,0,71
1147017,64,3,4,4,0,0,0,75
1147018,45,6,3,0,0,0,0,54
1147019,76,3,6,0,0,0,0,85
1147020,75,10,0,0,0,0,0,85
1147021,68,4,4,3,3,0,0,82
1147022,55,0,5,3,0,0,0,63
1147023,85,3,3,0,0,0,0,91
1147024,85,3,6,0,0,3,0,97
1147025,108,12,0,0,0,4,0,124
1147026,63,5,8,0,0,0,0,76
1147027,36,0,4,0,0,0,0,40
1147028,45,3,9,0,0,0,0,57
1147029,71,3,3,0,0,0,0,77
1147030,75,3,0,4,0,0,0,82
1147031,61,6,0,0,0,0,0,67
1147032,63,3,4,0,0,0,0,70
1147033,45,3,3,0,0,0,0,51
1147034,61,5,7,3,0,0,0,76
1147035,50,5,4,0,0,0,0,59
1147036,64,3,6,0,0,0,0,73
1147037,51,3,6,4,0,0,0,64
1147038,43,5,0,3,0,0,0,51
1147039,57,0,5,0,0,0,0,62
1147040,48,4,4,0,0,0,0,56
1147041,120,4,0,0,0,0,0,124
1147042,46,3,3,0,0,0,0,52
1147101,41,3,0,3,0,0,0,47
1147102,28,3,3,3,0,0,0,37
1147103,26,0,0,0,0,0,0,26
1147104,26,3,3,0,0,0,0,32
1147105,40,4,0,3,0,0,0,47
1147106,33,5,0,6,0,0,0,44
1147107,49,5,5,0,0,0,0,59
1147108,57,3,3,4,0,0,0,67
1147109,37,3,4,0,0,0,3,47
1147110,54,0,6,0,0,0,0,60
1147111,43,4,5,4,0,0,0,56
1147112,54,7,8,0,0,0,0,69
1147113,59,3,3,3,0,0,3,71
1147114,51,12,4,3,0,0,0,70
1147115,48,5,4,5,0,0,0,62
1147116,30,4,5,0,0,0,0,39
1147117,40,3,0,3,0,0,0,46
1147118,44,0,0,0,0,0,0,44
1147119,59,8,5,0,0,0,0,72
1147120,71,9,6,0,0,0,0,86
1147121,76,11,0,0,0,3,0,90
1147122,41,9,6,0,0,0,0,56
1147123,44,3,3,0,0,0,3,53
1147124,42,0,0,0,0,0,0,42
1147125,46,3,5,0,0,0,0,54
1147126,41,0,3,4,0,0,0,48
1147127,46,4,0,0,0,0,4,54
1147128,55,6,3,0,0,0,5,69
1147129,21,0,6,0,0,0,0,27
1147130,32,4,4,0,0,0,0,40
1147131,37,3,4,0,0,0,0,44
1147132,46,3,5,0,0,0,0,54
1147133,33,0,5,0,0,0,0,38
1147134,39,4,8,0,0,0,0,51
1147135,30,0,0,0,0,0,0,30
1147136,15,0,5,0,0,3,0,23
1147137,41,0,6,0,0,0,0,47
1147138,34,4,6,0,0,0,0,44
1147139,75,0,4,0,0,0,0,79
1147140,32,7,0,0,0,0,0,39
1147141,35,4,3,0,0,0,0,42
1147142,55,10,9,0,0,0,3,77
1147143,27,6,7,0,0,0,0,40
1147144,0,0,0,0,0,0,0,0
1147145,0,0,0,0,0,0,0,0
1147146,0,0,0,0,0,0,0,0
1147147,48,11,5,4,0,0,3,71
1147148,42,7,4,0,0,0,0,53
1147149,58,3,3,3,0,0,0,67
1147150,53,4,3,0,0,0,0,60
1147151,45,0,4,0,0,0,3,52
1147152,41,5,5,0,0,0,0,51
1147153,66,4,3,4,0,0,3,80
1147154,0,0,0,0,0,0,0,0
1147155,59,9,5,0,0,0,0,73
1147156,37,3,4,0,0,0,0,44
1147157,29,8,0,0,0,0,0,37
1147201,46,0,0,5,0,0,0,51
1147202,51,3,0,3,0,0,0,57
1147203,45,6,0,0,0,3,0,54
1147204,29,3,0,0,0,0,0,32
1147205,52,0,3,0,0,0,0,55
1147206,78,5,0,0,0,0,0,83
1147207,51,0,0,3,0,0,0,54
1147208,64,3,0,3,0,0,0,70
1147209,75,3,0,0,0,0,0,78
1147210,53,0,4,0,0,0,0,57
1147211,30,4,0,3,0,0,0,37
1147212,60,0,0,0,0,0,0,60
1147213,50,3,0,0,0,0,3,56
1147214,62,3,0,0,0,0,0,65
1147215,67,3,3,0,0,0,0,73
1147216,82,3,3,0,0,0,3,91
1147217,48,0,0,0,0,0,0,48
1147218,82,0,0,0,0,0,0,82
1147219,20,0,0,0,0,0,0,20
1147220,69,3,3,0,0,0,0,75
1147221,87,3,0,0,0,0,0,90
1147222,30,3,0,0,0,0,0,33
1147223,52,3,0,0,0,0,0,55
1147224,42,0,3,3,0,0,0,48
1147225,62,3,0,0,0,0,0,65
1147226,83,3,4,3,0,0,0,93
1147227,112,3,4,4,0,0,0,123
1147228,57,0,0,3,0,0,0,60
1147229,57,4,0,0,0,0,0,61
1147230,58,3,3,0,0,0,0,64
1147231,0,0,0,0,0,0,0,0
1147232,0,0,0,0,0,0,0,0
1147233,60,3,3,0,0,0,0,66
1147234,56,3,0,0,0,0,0,59
1147235,0,0,0,0,0,0,0,0
1147236,90,0,0,0,0,0,0,90
1147237,0,0,0,0,0,0,0,0
1147238,70,3,3,0,0,0,0,76
1147239,53,3,3,0,0,0,0,59
1147240,66,0,0,4,0,0,0,70
1147241,70,4,0,0,0,0,0,74
1147242,27,0,4,0,0,0,0,31
1147243,65,3,3,3,0,0,0,74
1147244,45,3,3,0,0,0,0,51
1147245,71,3,0,0,0,0,0,74
1147246,34,0,0,0,0,0,0,34
1147247,85,0,0,0,0,0,0,85
1147248,60,0,3,0,0,0,0,63
1147249,49,0,4,0,0,0,0,53
1147250,79,9,4,4,0,0,0,96
1147251,60,3,3,0,0,0,0,66
1147252,3,0,0,0,0,0,0,3
1147253,58,9,0,0,0,0,0,67
1147254,3,3,0,0,0,0,0,6
1147255,54,5,0,0,0,0,3,62
1147256,65,3,0,0,0,0,0,68
1147257,54,3,0,3,0,0,0,60
1147258,55,5,3,0,0,0,0,63
1147259,54,0,0,3,0,0,0,57
1147260,43,3,0,0,0,0,0,46
1147261,77,3,3,3,0,0,0,86
1147262,95,3,0,4,0,0,0,102
1147263,77,3,3,3,0,0,0,86
1147264,60,0,3,4,0,0,0,67
1147265,83,6,0,7,0,0,0,96
1147266,12,3,0,0,0,0,0,15
1147267,37,0,0,0,0,0,0,37
1147268,28,4,0,0,0,0,0,32
1147269,79,4,3,3,0,0,0,89
1147270,35,4,0,0,0,0,0,39
1147271,0,0,0,0,0,0,0,0
1147272,36,3,3,3,0,0,0,45
1147273,53,0,0,5,0,0,0,58
1147274,76,4,3,0,0,0,0,83
1147275,37,0,0,0,0,0,0,37
1147276,55,0,0,3,0,0,0,58
1147301,27,0,0,0,0,0,0,27
1147302,71,0,0,0,0,0,0,71
1147303,32,0,0,3,0,0,0,35
1147304,71,7,3,0,0,0,0,81
1147305,36,0,0,0,0,0,0,36
1147306,0,0,0,0,0,0,0,0
1147307,0,0,0,0,0,0,0,0
1147308,87,4,5,0,0,0,0,96
1147309,63,5,0,0,0,0,0,68
1147310,71,3,5,0,0,0,0,79
1147311,67,0,0,0,0,0,4,71
1147312,0,0,0,0,0,0,0,0
1147313,55,5,0,0,0,0,0,60
1147314,78,3,5,3,0,0,0,89
1147315,74,3,0,0,0,0,0,77
1147316,31,7,0,0,0,0,0,38
1147317,0,0,0,0,0,0,0,0
1147318,46,3,0,0,0,0,0,49
1147319,69,3,0,0,0,0,0,72
1147320,49,0,0,0,0,0,0,49
1147321,51,0,0,0,0,0,0,51
1147322,57,0,3,3,0,0,0,63
1147323,69,3,3,0,0,0,0,75
1147324,61,0,0,0,0,0,0,61
1147401,80,3,0,0,0,0,0,83
1147402,0,0,0,0,0,0,0,0
1147403,0,0,0,0,0,0,0,0
1147404,0,0,0,0,0,0,0,0
1147405,39,0,0,3,0,0,0,42
1147406,59,0,0,4,0,0,0,63
1147407,30,0,4,0,0,0,0,34
1147408,32,0,0,0,0,0,0,32
1147409,0,0,0,0,0,0,0,0
1147410,29,3,5,0,0,0,0,37
1147411,48,3,0,4,0,0,0,55
1147412,47,3,3,4,0,0,0,57
1147413,74,4,3,0,0,0,0,81
1147414,59,6,7,0,0,0,0,72
1147415,47,0,0,5,0,0,0,52
1147416,43,3,0,5,0,0,0,51
1147417,40,0,0,0,0,0,0,40
1147418,50,3,3,0,0,0,0,56
1147419,41,3,0,3,0,0,0,47
1147420,60,0,0,3,0,0,0,63
1147421,58,4,0,0,0,0,3,65
1147422,45,5,0,0,0,0,3,53
1147423,50,7,0,0,0,0,0,57
1147424,66,3,0,3,0,0,0,72
1147425,44,0,3,3,0,0,0,50
1147426,39,0,0,3,0,0,0,42
1147427,45,0,3,3,0,0,0,51
1147428,55,4,0,0,0,0,0,59
1147429,0,0,0,0,0,0,0,0
1147430,49,3,0,3,0,0,0,55
1147431,74,3,0,3,0,0,3,83
1147432,41,3,0,3,0,0,0,47
1147433,68,6,3,3,0,0,0,80
1147434,64,3,0,0,0,0,0,67
1147435,91,0,3,3,0,0,3,100
1147436,50,4,0,0,0,0,0,54
1147437,79,10,0,4,0,0,0,93
1147438,45,3,0,0,0,0,0,48
1147439,33,5,0,0,0,0,0,38
1147440,0,0,0,0,0,0,0,0
1147441,71,3,3,0,0,0,0,77
1147442,64,0,0,6,0,0,0,70
1147443,30,0,0,0,0,0,0,30
1147444,44,0,3,0,0,0,0,47
1147445,214,12,6,8,0,0,0,240
1147446,68,8,3,3,0,0,0,82
1147447,46,4,3,0,0,0,0,53
1147448,71,0,0,0,0,0,0,71
1147449,90,3,0,4,0,0,0,97
1147450,44,6,0,0,0,0,0,50
1147451,48,0,0,3,0,0,0,51
1147452,52,0,3,0,0,0,0,55
1147453,18,0,0,0,0,0,0,18
1147454,25,3,3,0,0,0,0,31
1147455,41,3,0,0,0,0,0,44
1147456,0,0,0,0,0,0,0,0
1147457,65,4,0,0,0,0,0,69
1147458,79,5,0,4,0,0,0,88
1147459,61,8,0,0,0,0,0,69
1147460,41,4,0,4,0,0,0,49
1147461,66,3,0,3,0,0,0,72
1147462,47,4,0,4,0,0,0,55
1147463,53,3,0,0,0,0,0,56
1147464,25,0,0,3,0,0,0,28
1147465,41,3,4,0,0,0,0,48
1147466,58,5,3,3,0,0,0,69
1147467,42,0,0,4,0,0,0,46
1147468,57,0,0,0,0,0,0,57
1147469,44,0,0,0,0,0,0,44
1147470,72,3,4,3,0,0,0,82
1147471,36,3,3,3,0,0,0,45
1147472,35,6,0,0,0,0,0,41
1147473,36,3,0,0,0,0,0,39
1147474,52,0,0,0,0,0,0,52
1147475,36,0,4,0,0,0,0,40
1147476,48,0,0,3,0,0,0,51
1147501,0,0,0,0,0,0,0,0
1147601,49,0,0,0,0,0,0,49
1147602,70,4,0,0,0,0,0,74
1147603,62,0,0,0,0,0,0,62
1147604,62,0,0,0,0,0,0,62
1147605,64,3,0,0,0,0,0,67
1147606,52,3,3,0,0,0,0,58
1147607,58,5,0,0,0,0,0,63
1147608,91,3,0,3,0,0,0,97
1147609,75,6,0,0,0,0,0,81
1147610,77,0,3,0,0,0,0,80
1147611,58,3,0,0,0,0,0,61
1147612,66,7,3,0,0,0,0,76
1147613,45,3,0,0,0,0,0,48
1147614,58,5,0,0,0,0,0,63
1147615,99,6,0,0,0,0,0,105
1147616,49,0,0,0,0,0,0,49
1147617,80,9,0,0,0,0,0,89
1147618,51,3,3,0,0,0,0,57
1147619,73,0,0,0,0,0,0,73
1147620,54,3,5,0,0,0,0,62
1147621,56,0,0,0,0,0,0,56
1147622,67,7,0,3,0,0,0,77
1147623,69,7,3,0,0,0,0,79
1147624,87,5,3,0,0,0,0,95
1147625,79,5,0,0,0,0,0,84
1147626,72,3,3,4,0,0,0,82
1147627,45,3,0,0,0,0,0,48
1147628,67,4,3,6,0,0,0,80
1147629,59,5,0,0,0,0,0,64
1147630,64,0,3,3,0,0,0,70
1147631,64,5,3,0,0,0,0,72
1147632,60,3,0,4,0,0,0,67
1147633,87,3,7,4,0,0,0,101
1147634,55,0,0,0,0,0,0,55
1147635,70,6,0,3,0,0,0,79
1147636,51,3,0,0,0,0,0,54
1147637,81,4,0,0,0,0,4,89
1147638,58,3,0,0,0,0,0,61
1147639,59,3,3,0,0,0,0,65
1147640,58,0,0,0,0,0,0,58
1147641,54,5,0,0,0,0,0,59
1147642,99,4,0,0,0,0,0,103
1147643,55,3,3,0,0,3,0,64
1147644,71,5,0,0,0,0,0,76
1147645,55,5,0,3,0,0,0,63
1147646,80,5,0,0,0,0,0,85
1147647,54,3,0,0,0,0,0,57
1147648,66,3,3,0,0,0,0,72
1147649,76,5,3,0,0,0,0,84
1147650,56,0,0,0,0,0,0,56
1147651,31,3,0,0,0,0,0,34
1147652,77,10,0,0,0,0,0,87
1147653,90,3,0,0,0,0,0,93
1147654,40,0,0,0,0,0,0,40
1147655,84,0,3,3,0,0,0,90
1147656,27,0,0,0,0,0,0,27
1147701,76,0,0,0,0,0,0,76
1147702,0,0,0,0,0,0,0,0
1147703,27,0,4,0,0,0,0,31
1147704,38,0,0,0,0,0,0,38
1147705,0,0,0,0,0,0,0,0
1147706,60,7,0,0,0,0,0,67
1147707,47,3,0,0,0,0,0,50
1147708,52,4,4,0,0,0,0,60
1147709,28,0,0,0,0,0,0,28
1147710,43,0,0,0,0,0,0,43
1147711,48,4,0,0,0,0,0,52
1147712,26,0,0,0,0,0,0,26
1147713,36,4,0,0,0,0,0,40
1147714,54,3,3,3,0,0,0,63
1147715,69,6,3,0,0,0,0,78
1147716,29,0,4,0,0,0,0,33
1147717,64,0,0,3,0,0,0,67
1147718,90,3,3,3,0,0,0,99
1147719,56,4,0,4,0,0,0,64
1147720,51,3,0,0,0,0,0,54
1147721,3,0,0,0,0,0,0,3
1147722,39,3,0,0,0,0,0,42
1147723,0,0,0,0,0,0,0,0
1147724,43,0,3,0,0,0,0,46
1147725,57,4,0,0,0,0,0,61
1147726,65,7,3,0,0,0,0,75
1147727,75,0,0,0,0,0,0,75
1147728,44,3,0,3,0,0,0,50
1147729,80,0,3,3,0,0,0,86
1147730,0,0,0,0,0,0,0,0
1147731,32,3,3,0,0,0,0,38
1147732,38,3,0,4,0,0,0,45
1147733,45,0,0,0,0,0,0,45
1147734,64,3,3,3,0,0,0,73
1147735,26,0,0,0,0,0,3,29
1147736,50,0,0,0,0,0,0,50
1147737,67,3,3,3,0,0,0,76
1147738,51,4,0,0,0,0,0,55
1147739,0,0,0,0,0,0,0,0
1147740,76,4,5,0,0,0,0,85
1147741,48,3,5,0,0,0,0,56
1147742,66,3,3,0,0,3,0,75
1147743,29,3,3,0,0,0,0,35
1147744,79,5,0,0,0,0,0,84
1147745,69,3,3,0,0,3,0,78
1147746,69,3,3,0,0,0,0,75
1147747,59,0,0,0,0,0,0,59
1147748,53,3,0,0,0,0,0,56
1147749,52,3,3,0,0,0,0,58
1147750,81,6,0,0,0,0,0,87
1147751,32,0,0,0,0,0,0,32
1147752,35,4,0,0,0,0,0,39
1147801,31,3,0,0,0,0,0,34
1147802,46,0,3,0,0,0,0,49
1147803,33,0,3,0,0,0,0,36
1147804,39,0,0,0,0,0,4,43
1147805,45,0,3,0,0,0,0,48
1147806,24,0,0,0,0,0,0,24
1147807,35,0,0,3,0,0,0,38
1147808,47,0,0,0,0,0,0,47
1147809,36,3,0,0,0,0,3,42
1147810,68,7,0,0,0,0,0,75
1147811,58,0,3,0,0,0,0,61
1147812,36,0,0,0,0,0,0,36
1147813,66,4,4,0,0,0,0,74
1147814,54,0,0,8,0,0,0,62
1147815,67,0,0,0,0,0,0,67
1147816,81,7,0,0,0,0,0,88
1147817,40,3,0,0,0,0,0,43
1147818,50,0,5,0,0,0,0,55
1147819,87,0,0,0,0,0,0,87
1147820,19,4,0,0,0,0,0,23
1147821,37,3,0,0,0,0,0,40
1147822,33,0,4,0,0,0,0,37
1147823,41,0,3,3,0,0,0,47
1147824,69,0,4,0,0,0,0,73
1147825,105,6,0,0,0,0,0,111
1147826,67,0,3,3,0,0,0,73
1147827,41,4,0,0,0,0,0,45
1147828,40,7,0,0,0,0,0,47
1147829,65,4,0,5,0,0,0,74
1147830,71,0,0,0,0,0,0,71
1147831,49,0,3,0,0,0,0,52
1147832,45,3,0,0,0,0,3,51
1147833,41,0,0,0,0,0,0,41
1147834,69,3,3,0,0,0,0,75
1147835,40,0,3,0,0,0,0,43
1147836,59,3,3,0,0,0,0,65
1147837,58,0,3,0,0,0,0,61
1147838,70,3,3,0,0,0,0,76
1147901,66,0,5,0,0,0,0,71
1147902,72,6,4,0,0,0,0,82
1147903,81,0,3,0,0,0,0,84
1147904,37,9,0,4,0,0,0,50
1147905,30,5,0,0,0,0,0,35
1147906,51,4,3,0,0,0,0,58
1147907,78,0,4,3,0,0,0,85
1147908,66,3,0,3,0,0,0,72
1147909,0,0,0,0,0,0,0,0
1147910,33,0,0,0,0,0,0,33
1147911,66,3,0,0,0,0,3,72
1147912,52,0,0,0,0,0,0,52
1147913,76,7,5,0,0,0,0,88
1147914,43,0,0,0,0,0,0,43
1147915,47,0,4,0,0,0,0,51
1147916,40,0,3,3,0,0,0,46
1147917,0,0,0,0,0,0,0,0
1147918,63,3,3,3,0,0,0,72
1147919,56,5,0,0,0,0,0,61
1147920,56,4,0,0,0,0,0,60
1147921,51,0,0,0,0,0,0,51
1147922,31,0,0,4,0,0,0,35
1147923,70,3,3,0,0,0,0,76
1147924,84,3,3,0,0,0,0,90
1147925,75,4,0,0,0,0,0,79
1147926,77,0,0,0,0,0,0,77
1147927,63,3,0,0,0,0,0,66
1147928,0,0,0,0,0,0,0,0
1147929,28,0,0,0,0,0,0,28
1147930,70,3,0,5,0,3,0,81
1147931,34,3,3,4,0,0,0,44
1147932,31,3,3,0,0,0,0,37
1147933,31,0,0,0,0,0,0,31
1147934,59,0,0,0,0,0,0,59
1147935,0,0,0,0,0,0,0,0
1147936,0,0,0,0,0,0,0,0
1147937,0,0,0,0,0,0,0,0
1147938,0,0,0,0,0,0,0,0
1147939,40,0,0,0,0,0,0,40
1147940,66,3,0,4,0,0,0,73
1147941,40,3,0,5,0,0,0,48
1147942,74,6,0,0,0,0,0,80
1147943,54,4,3,0,0,0,0,61
1148001,56,4,4,0,0,0,0,64
1148002,25,0,0,0,0,0,0,25
1148003,31,0,0,0,0,0,0,31
1148004,55,0,3,5,3,0,0,66
1148005,40,0,0,6,0,0,0,46
1148006,65,3,3,0,0,0,0,71
1148007,52,7,0,3,0,0,0,62
1148008,79,0,0,0,0,0,3,82
1148009,44,3,0,3,0,0,3,53
1148010,64,4,0,0,0,0,0,68
1148011,35,0,0,0,0,0,0,35
1148012,43,5,0,0,0,0,0,48
1148013,74,3,3,3,0,0,0,83
1148014,33,0,3,3,0,0,0,39
1148015,74,3,3,0,0,0,0,80
1148016,63,5,3,3,0,0,3,77
1148017,33,0,0,0,0,0,0,33
1148018,0,0,0,0,0,0,0,0
1148019,53,7,0,0,0,0,0,60
1148020,70,4,3,0,0,0,0,77
1148021,22,0,0,0,0,0,3,25
1148022,47,3,0,0,0,0,0,50
1148023,35,0,0,4,0,0,0,39
1148024,70,4,0,4,3,0,0,81
1148025,53,3,3,3,0,0,0,62
1148026,58,4,3,3,0,3,0,71
1148027,37,0,3,0,0,0,3,43
1148028,56,0,0,0,0,0,0,56
1148029,55,0,0,3,0,0,0,58
1148030,53,3,0,0,0,0,0,56
1148031,36,4,3,0,0,0,0,43
1148032,67,4,0,0,0,0,3,74
1148101,56,4,0,0,0,0,0,60
1148102,30,3,0,0,0,0,0,33
1148103,78,3,0,0,0,0,4,85
1148104,75,0,3,0,0,0,0,78
1148105,41,0,0,0,0,0,0,41
1148106,78,3,0,0,0,0,0,81
1148107,43,0,0,3,0,0,0,46
1148108,62,4,0,5,0,0,0,71
1148109,40,0,3,0,0,0,0,43
1148110,59,0,0,0,0,0,0,59
1148111,67,0,4,0,0,0,0,71
1148112,89,6,3,0,0,0,0,98
1148113,78,3,3,0,0,0,0,84
1148114,44,0,0,3,0,0,0,47
1148115,44,0,4,0,0,0,0,48
1148116,50,0,0,0,0,0,0,50
1148117,43,3,3,3,3,0,0,55
1148118,37,4,4,0,0,0,0,45
1148119,63,5,0,0,0,0,0,68
1148120,55,5,0,0,0,0,0,60
1148121,31,3,0,0,0,0,0,34
1148122,77,3,0,0,0,0,0,80
1148123,52,0,0,0,0,0,0,52
1148124,65,4,3,0,0,0,0,72
1148125,61,0,0,0,0,0,0,61
1148126,61,0,0,0,0,0,0,61
1148127,47,0,6,0,0,0,3,56
1148128,33,3,0,3,0,0,0,39
1148129,37,4,0,0,0,0,0,41
1148130,38,0,0,0,0,0,0,38
1148131,57,7,0,0,0,0,0,64
1148132,29,0,3,0,0,0,0,32
1148133,0,0,0,0,0,0,0,0
1148134,0,0,0,0,0,0,0,0
1148135,13,4,0,0,0,0,0,17
1148136,48,0,3,0,0,0,0,51
1148137,57,3,0,0,0,0,0,60
1148138,63,0,0,0,0,0,0,63
1148139,66,3,0,0,0,0,0,69
1148140,63,0,5,0,0,0,0,68
1148141,43,0,8,0,0,0,0,51
1148142,38,3,0,0,0,0,0,41
1148143,0,0,0,0,0,0,0,0
1148144,0,0,0,0,0,0,0,0
1148145,64,0,0,4,0,0,0,68
1148146,33,0,0,0,0,0,0,33
1148201,132,8,5,0,0,0,0,145
1148202,92,4,11,0,0,0,0,107
1148203,6,0,0,0,0,0,0,6
1148204,131,5,0,0,0,0,0,136
1148205,42,0,4,0,0,0,0,46
1148206,48,0,0,0,0,0,0,48
1148207,0,0,0,0,0,0,0,0
1148208,46,4,0,0,0,0,0,50
1148209,68,0,0,0,0,0,0,68
1148210,41,3,0,0,0,0,0,44
1148211,59,0,0,6,0,0,0,65
1148212,83,3,0,3,0,0,0,89
1148213,43,3,0,0,0,0,0,46
1148214,48,3,0,3,0,0,0,54
1148215,76,5,0,0,0,0,3,84
1148216,64,3,3,0,0,0,0,70
1148217,44,3,0,0,0,0,0,47
1148218,29,7,5,0,0,0,0,41
1148219,72,0,3,0,0,0,0,75
1148220,63,0,3,0,0,0,3,69
1148221,71,3,0,0,0,0,4,78
1148222,37,0,0,0,0,0,0,37
1148223,48,4,0,0,0,0,0,52
1148224,79,5,3,0,0,0,0,87
1148225,48,5,3,3,0,0,0,59
1148226,72,5,0,3,0,0,3,83
1148227,31,5,0,0,0,0,0,36
1148228,58,0,0,0,0,0,0,58
1148229,24,3,3,0,0,0,0,30
1148230,65,0,3,3,0,0,0,71
1148231,37,0,3,0,0,0,0,40
1148232,35,0,0,0,0,0,4,39
1148233,32,3,0,0,0,0,0,35
1148234,37,3,3,3,0,0,0,46
1148235,28,3,0,0,0,0,0,31
1148236,77,4,3,0,0,0,0,84
1148237,53,0,0,0,0,0,0,53
1148238,34,5,0,0,0,0,0,39
1148239,60,3,0,0,0,0,0,63
1148240,44,3,0,0,0,0,0,47
1148241,48,0,3,0,0,0,0,51
1148242,46,3,0,0,0,0,0,49
1148243,41,4,0,0,0,0,0,45
1148244,71,0,4,0,0,0,0,75
1148245,54,6,0,0,0,0,0,60
1148246,62,0,0,0,0,3,0,65
1148247,89,4,0,5,0,0,0,98
1148248,70,3,3,0,0,0,0,76
1148249,77,3,3,0,0,0,0,83
1148250,61,0,3,0,0,0,0,64
1148251,42,0,0,0,0,0,0,42
1148252,58,5,3,0,0,0,4,70
1148253,31,3,0,0,0,0,0,34
1148254,41,0,0,0,0,0,0,41
1148255,38,3,0,0,0,0,0,41
1148256,105,3,5,0,0,0,0,113
1148257,24,3,0,0,0,0,0,27
1148258,66,3,3,0,0,0,0,72
1148301,41,5,3,0,0,0,0,49
1148302,70,0,4,0,0,0,5,79
1148303,26,3,3,0,0,0,0,32
1148304,64,5,0,0,0,0,0,69
1148305,87,3,3,0,0,0,0,93
1148306,0,0,0,0,0,0,0,0
1148307,50,0,3,3,0,0,0,56
1148308,38,0,0,4,0,0,0,42
1148309,32,3,0,0,3,0,0,38
1148310,54,4,0,3,0,0,0,61
1148311,53,4,0,0,0,0,0,57
1148312,59,0,0,3,0,0,0,62
1148313,47,0,0,0,0,0,0,47
1148314,63,4,4,0,0,0,0,71
1148315,81,8,0,0,0,0,0,89
1148316,32,0,3,0,0,0,0,35
1148317,55,3,4,3,0,0,0,65
1148318,42,0,0,0,0,0,0,42
1148319,37,3,0,0,0,3,0,43
1148320,48,3,3,3,0,0,0,57
1148321,54,0,3,0,0,0,0,57
1148322,58,3,3,0,0,0,3,67
1148323,43,3,3,3,0,0,0,52
1148324,74,5,0,0,0,0,0,79
1148325,64,0,3,4,0,0,0,71
1148326,26,0,5,0,0,0,0,31
1148327,23,0,0,0,0,0,0,23
1148328,45,0,3,3,0,0,0,51
1148329,63,3,3,0,0,0,3,72
1148330,48,0,4,0,0,0,0,52
1148331,68,3,3,0,0,0,0,74
1148332,87,3,5,0,0,0,0,95
1148333,71,4,0,5,0,0,0,80
1148334,0,0,0,0,0,0,0,0
1148335,62,4,0,0,0,0,0,66
1148336,52,0,0,3,0,0,0,55
1148337,59,3,0,0,0,0,0,62
1148338,53,3,0,0,0,0,0,56
1148339,55,4,3,0,0,0,3,65
1148340,66,4,0,0,0,0,0,70
1148341,51,0,3,3,0,0,0,57
1148342,81,3,3,3,0,0,0,90
1148401,67,5,0,5,0,0,0,77
1148402,68,0,3,0,0,0,0,71
1148403,65,3,3,0,0,0,0,71
1148404,57,3,4,0,0,0,0,64
1148405,44,7,4,0,0,0,0,55
1148406,63,3,3,3,3,0,0,75
1148407,51,6,0,3,0,0,0,60
1148408,66,5,3,0,0,0,0,74
1148409,19,0,0,0,0,0,0,19
1148410,45,3,3,3,0,0,0,54
1148411,33,3,3,3,0,0,0,42
1148412,40,7,0,0,0,0,0,47
1148413,64,3,3,3,0,3,3,79
1148414,37,4,0,0,0,0,0,41
1148415,29,3,3,0,0,0,0,35
1148416,54,0,3,0,0,0,0,57
1148417,28,3,0,0,0,0,0,31
1148418,0,0,0,0,0,0,0,0
1148419,41,6,0,3,0,0,0,50
1148420,70,6,0,4,0,0,0,80
1148421,54,7,4,0,0,0,0,65
1148422,38,4,0,0,0,0,0,42
1148423,55,3,3,0,0,0,0,61
1148424,50,0,0,0,0,0,0,50
1148425,51,3,4,0,0,0,0,58
1148426,48,0,4,0,0,0,0,52
1148427,64,3,4,3,0,0,0,74
1148428,58,4,0,0,0,0,0,62
1148429,58,3,3,0,0,0,0,64
1148430,65,0,0,0,0,0,0,65
1148431,42,5,3,3,0,0,0,53
1148432,60,9,0,0,0,0,0,69
1148433,51,4,4,0,0,0,0,59
1148434,50,4,3,0,0,0,0,57
1148435,54,4,8,0,0,0,0,66
1148436,42,3,0,0,0,0,0,45
1148437,84,3,3,0,0,0,0,90
1148438,50,3,5,0,0,0,0,58
1148439,43,0,6,0,0,0,0,49
1148440,39,6,0,0,0,0,0,45
1148441,47,3,3,0,0,0,0,53
1148442,52,8,3,0,0,0,0,63
1148501,48,3,3,0,0,0,0,54
1148502,59,3,0,0,0,0,0,62
1148503,67,7,3,0,0,0,0,77
1148504,63,5,3,0,0,0,0,71
1148505,49,3,3,0,0,0,0,55
1148506,41,3,0,0,0,0,0,44
1148507,49,3,3,0,0,0,0,55
1148508,44,0,4,0,0,0,0,48
1148509,57,7,3,0,0,0,0,67
1148510,42,0,0,0,0,0,0,42
1148511,64,3,3,4,0,0,0,74
1148512,77,4,0,0,0,0,0,81
1148513,64,0,0,0,0,0,0,64
1148514,66,5,4,0,0,0,0,75
1148515,40,0,0,0,0,0,0,40
1148516,61,0,0,0,0,0,3,64
1148517,62,4,3,0,0,0,0,69
1148518,55,0,3,0,0,0,0,58
1148519,65,4,0,0,3,0,0,72
1148520,52,4,0,0,0,0,0,56
1148521,63,0,0,0,0,0,0,63
1148522,71,0,0,0,0,0,0,71
1148523,22,4,3,0,0,0,0,29
1148524,36,4,3,0,0,0,0,43
1148525,41,0,0,3,0,0,0,44
1148526,81,7,0,0,0,0,0,88
1148527,27,0,0,0,0,0,0,27
1148528,46,5,0,0,0,0,0,51
1148529,54,3,3,0,0,0,0,60
1148530,50,3,3,0,0,0,0,56
1148531,57,3,3,0,0,0,0,63
1148532,66,3,0,0,0,0,0,69
1148533,65,3,0,0,0,0,0,68
1148534,49,0,3,0,0,0,0,52
1148535,54,0,3,0,0,0,3,60
1148536,62,3,3,3,0,0,0,71
1148537,39,4,0,0,0,0,0,43
1148538,84,4,0,0,0,0,0,88
1148539,56,3,0,0,0,0,0,59
1148540,45,6,0,4,0,0,0,55
1148541,57,4,0,0,0,0,0,61
1148542,62,3,0,0,0,0,0,65
1148543,33,3,0,0,0,0,0,36
1148544,36,4,0,0,0,0,0,40
1148545,40,0,0,5,0,0,0,45
1148546,47,5,0,0,0,0,0,52
1148547,63,4,0,0,0,0,0,67
1148548,16,0,0,0,0,0,0,16
1148549,44,6,0,0,0,0,0,50
1148550,47,0,0,5,0,0,0,52
1148551,60,5,0,4,0,0,0,69
1148552,54,0,3,0,0,0,0,57
1148553,59,3,0,0,0,0,0,62
1148554,49,0,0,0,0,0,4,53
1148555,36,0,0,3,0,0,0,39
1148556,51,0,0,0,0,0,0,51
1148557,23,0,3,0,0,0,0,26
1148558,37,3,0,0,0,0,0,40
1148601,0,0,0,0,0,0,0,0
1148701,3,0,0,0,0,0,0,3
1148801,30,4,0,0,0,0,0,34
1148802,76,4,0,0,0,0,0,80
1148803,56,3,0,0,0,0,0,59
1148804,61,6,3,3,0,0,0,73
1148805,71,5,0,0,0,0,0,76
1148806,26,4,0,0,0,0,0,30
1148807,59,0,0,0,0,0,0,59
1148808,45,0,3,0,0,0,0,48
1148809,69,0,3,0,0,0,0,72
1148810,38,0,0,3,0,0,0,41
1148811,79,0,0,3,0,0,0,82
1148812,0,0,0,0,0,0,0,0
1148813,55,0,4,0,0,0,0,59
1148814,63,3,0,0,0,0,0,66
1148815,88,5,0,0,0,0,0,93
1148816,43,4,0,0,0,0,0,47
1148817,102,3,0,3,0,0,0,108
1148818,40,5,0,0,0,0,0,45
1148819,45,0,0,0,0,0,0,45
1148820,38,0,3,0,0,0,0,41
1148821,48,3,0,0,0,0,0,51
1148822,63,0,0,0,0,0,0,63
1148823,78,0,5,0,0,3,0,86
1148824,67,3,0,0,0,0,0,70
1148825,56,0,0,0,0,0,0,56
1148826,64,0,0,0,0,0,4,68
1148827,67,0,3,0,0,0,0,70
1148828,81,3,0,0,0,0,0,84
1148829,35,0,0,0,0,0,0,35
1148830,76,9,0,0,0,0,4,89
1148831,51,3,3,0,0,0,0,57
1148832,72,6,3,3,0,0,0,84
1148833,50,0,0,5,0,0,0,55
1148834,78,6,0,0,0,0,0,84
1148835,39,3,3,0,0,0,0,45
1148836,69,3,0,3,0,0,0,75
1148837,47,0,0,0,0,0,0,47
1148838,62,3,0,0,0,0,0,65
1148839,75,0,0,0,0,0,0,75
1148840,31,3,0,0,0,0,0,34
1148841,54,0,0,3,0,0,0,57
1148842,42,3,0,0,0,0,0,45
1148843,40,4,0,0,0,0,0,44
1148844,57,7,0,0,0,0,0,64
1148845,74,0,0,0,0,0,0,74
1148846,30,0,3,0,0,0,0,33
1148847,53,3,0,0,0,0,0,56
1148848,61,3,0,0,0,0,0,64
1148849,48,0,0,0,0,0,0,48
1148850,25,0,0,0,0,0,0,25
1148851,56,3,0,3,0,0,0,62
1148852,68,0,4,0,0,0,0,72
1148853,86,4,0,0,0,0,0,90
1148854,27,0,0,0,0,0,0,27
1148855,51,0,0,0,0,0,0,51
1148856,35,4,0,0,0,0,0,39
1148857,65,0,0,0,0,0,0,65
1148858,48,0,3,0,0,0,0,51
1148859,44,5,0,0,0,0,0,49
1148860,63,0,4,0,0,0,0,67
1148861,53,4,0,0,0,0,0,57
1148862,34,0,0,0,0,0,0,34
1148901,66,3,3,0,0,0,0,72
1148902,49,4,3,0,0,0,0,56
1148903,39,3,0,0,0,0,3,45
1148904,65,3,3,0,0,0,0,71
1148905,11,3,0,0,0,0,0,14
1148906,44,4,0,0,0,0,0,48
1148907,18,0,3,3,0,0,0,24
1148908,32,0,0,0,0,0,0,32
1148909,26,3,0,0,0,0,0,29
1148910,38,5,3,0,0,0,0,46
1148911,54,0,0,0,0,0,3,57
1148912,22,0,0,0,0,0,3,25
1148913,41,0,0,0,0,0,0,41
1148914,0,0,0,0,0,0,0,0
1148915,47,4,0,0,0,0,0,51
1148916,61,0,3,0,0,3,0,67
1148917,15,0,0,0,0,0,0,15
1148918,36,0,3,0,0,0,0,39
1148919,31,3,0,0,0,0,0,34
1148920,48,0,0,0,0,0,0,48
1148921,30,4,0,0,0,0,0,34
1148922,31,3,0,3,0,0,0,37
1148923,30,0,0,0,0,0,0,30
1148924,34,3,3,0,0,0,0,40
1148925,36,4,0,4,0,0,0,44
1148926,52,3,0,0,0,0,3,58
1148927,28,0,0,0,0,0,0,28
1148928,35,3,0,4,0,0,0,42
1148929,26,0,3,0,0,0,0,29
1148930,17,3,0,0,0,0,0,20
1148931,27,3,0,0,0,0,0,30
1148932,21,4,0,0,0,0,0,25
1148933,43,0,0,0,0,0,0,43
1148934,37,3,3,0,0,0,0,43
1148935,47,3,3,0,0,0,0,53
1148936,33,0,4,0,0,0,3,40
1148937,39,0,0,0,0,0,0,39
1148938,33,0,0,0,0,0,0,33
1148939,23,0,0,0,0,0,0,23
1148940,40,0,3,0,0,0,0,43
1148941,60,4,0,0,0,0,0,64
1148942,36,0,0,0,0,0,0,36
1148943,38,3,0,0,0,0,0,41
1148944,60,4,3,0,0,0,3,70
1148945,45,0,0,0,0,0,0,45
1148946,58,3,3,0,0,0,0,64
1148947,44,3,0,0,0,0,0,47
1148948,10,0,0,0,0,0,4,14
1148949,20,3,3,3,0,0,0,29
1148950,60,3,3,3,0,0,0,69
1149001,75,0,4,0,0,0,0,79
1149002,72,6,0,0,0,0,0,78
1149003,48,0,0,0,0,0,0,48
1149004,59,3,0,0,0,0,0,62
1149005,39,3,0,4,0,0,0,46
1149006,69,5,0,0,0,0,0,74
1149007,80,5,3,3,0,0,0,91
1149008,56,0,0,0,0,0,0,56
1149009,78,3,0,0,0,0,0,81
1149010,47,0,4,0,0,0,0,51
1149011,45,0,0,0,0,0,0,45
1149012,38,3,3,0,0,0,0,44
1149013,57,3,0,0,0,0,3,63
1149014,60,0,0,0,0,0,0,60
1149015,80,9,0,0,0,0,0,89
1149016,71,9,0,0,0,0,0,80
1149017,63,3,0,3,0,0,0,69
1149018,79,4,0,0,0,0,0,83
1149101,54,4,0,0,0,0,0,58
1149102,56,10,0,0,0,0,0,66
1149103,62,3,4,0,0,0,0,69
1149104,0,0,0,0,0,0,0,0
1149105,73,3,0,0,0,0,0,76
1149106,169,7,3,0,0,0,0,179
1149107,97,3,0,5,0,0,0,105
1149108,85,3,0,0,0,0,0,88
1149109,67,0,0,0,0,0,0,67
1149110,0,0,0,0,0,0,0,0
1149111,68,3,0,0,0,0,0,71
1149112,51,0,0,0,0,0,0,51
1149113,45,0,0,0,0,0,0,45
1149114,54,3,0,0,0,0,0,57
1149115,77,5,0,0,0,0,0,82
1149116,64,0,0,0,0,0,0,64
1149117,58,0,0,0,0,0,0,58
1149118,62,4,0,0,0,0,0,66
1149119,41,0,3,0,0,0,0,44
1149120,37,0,0,0,0,0,0,37
1149121,43,4,4,0,0,0,4,55
1149122,52,3,0,0,0,0,0,55
1149123,50,0,0,0,0,0,0,50
1149124,45,3,3,0,0,0,0,51
1149125,38,5,3,0,0,0,0,46
1149126,49,3,0,0,0,0,0,52
1149127,0,0,0,0,0,0,0,0
1149128,39,5,0,0,0,0,0,44
1149129,74,3,3,0,0,0,0,80
1149130,43,3,3,0,0,0,0,49
1149131,87,3,0,0,0,0,0,90
1149132,103,6,3,3,0,0,0,115
1149133,80,6,0,0,0,0,0,86
1149134,30,4,0,0,0,0,0,34
1149135,70,0,0,5,0,0,0,75
1149201,55,0,0,0,0,0,0,55
1149202,35,0,0,3,0,0,0,38
1149203,44,4,0,0,0,0,0,48
1149204,131,5,0,0,0,0,0,136
1149205,34,4,0,3,0,0,0,41
1149206,23,0,0,0,0,0,0,23
1149207,38,0,4,0,0,0,0,42
1149208,39,3,3,0,0,0,0,45
1149209,0,0,0,0,0,0,0,0
1149210,0,0,0,0,0,0,0,0
1149211,51,3,0,0,0,0,0,54
1149212,43,0,3,0,0,0,0,46
1149213,47,0,3,0,0,0,0,50
1149214,42,4,0,0,0,0,0,46
1149215,42,3,3,0,0,0,0,48
1149216,37,0,0,0,0,0,0,37
1149217,60,4,0,0,0,0,0,64
1149218,37,3,3,0,0,0,0,43
1149219,65,0,3,0,0,0,0,68
1149220,58,4,0,0,0,0,0,62
1149221,53,0,0,0,0,0,0,53
1149222,30,3,0,0,0,0,0,33
1149223,32,0,0,0,0,0,0,32
1149224,30,3,0,0,0,0,0,33
1149225,40,0,0,3,0,0,0,43
1149226,30,0,0,0,0,0,0,30
1149227,51,3,0,0,0,0,4,58
1149228,54,0,0,0,0,0,0,54
1149229,52,3,0,0,0,0,0,55
1149230,49,3,0,0,0,0,0,52
1149231,32,3,3,0,0,0,0,38
1149232,37,4,0,0,0,0,0,41
1149233,39,3,0,0,0,0,0,42
1149234,52,0,0,0,0,0,0,52
1149235,45,4,0,0,0,0,0,49
1149236,34,3,0,3,0,0,0,40
1149237,39,3,3,0,0,0,0,45
1149238,60,0,0,0,0,0,0,60
1149239,26,0,0,0,0,0,0,26
1149240,34,3,0,0,0,0,0,37
1149241,43,0,0,0,0,0,0,43
1149242,76,0,0,0,0,0,0,76
1149243,35,3,0,0,0,0,0,38
1149244,26,3,0,0,0,0,0,29
1149245,38,4,0,0,0,0,0,42
1149246,24,4,0,3,0,0,0,31
1149247,55,3,0,0,0,0,0,58
1149248,79,0,0,0,0,0,0,79
1149249,50,0,0,4,0,0,0,54
1149250,48,0,0,0,0,0,0,48
1149251,38,0,0,0,0,0,0,38
1149301,47,0,0,0,0,0,0,47
1149302,66,3,3,0,0,0,0,72
1149303,34,3,3,0,0,3,0,43
1149304,45,4,0,4,0,0,0,53
1149305,58,3,3,0,0,0,0,64
1149306,65,7,0,0,0,0,0,72
1149307,82,8,0,0,0,0,0,90
1149308,0,0,0,0,0,0,0,0
1149309,67,3,4,0,0,0,0,74
1149310,44,0,3,0,0,0,3,50
1149311,32,3,0,0,0,0,0,35
1149312,79,3,3,3,0,0,0,88
1149313,45,3,3,0,0,0,3,54
1149314,50,0,0,3,0,0,0,53
1149315,64,3,3,3,0,0,0,73
1149316,54,7,0,0,0,0,0,61
1149317,71,3,0,0,0,0,0,74
1149318,24,0,0,0,0,0,0,24
1149319,3,0,0,0,0,0,0,3
1149320,71,4,4,0,0,0,0,79
1149321,52,3,3,0,0,0,3,61
1149322,50,0,4,0,0,0,0,54
1149323,48,0,0,3,0,0,0,51
1149324,65,3,0,3,0,0,0,71
1149325,55,6,0,0,0,0,4,65
1149326,69,0,0,3,0,0,0,72
1149327,34,3,3,0,0,0,0,40
1149328,45,0,3,0,0,0,0,48
1149329,53,4,3,0,0,0,0,60
1149330,46,3,3,0,0,0,0,52
1149331,60,4,0,0,0,0,0,64
1149332,64,0,0,0,0,0,0,64
1149333,56,3,0,4,0,0,0,63
1149334,54,0,0,0,0,0,0,54
1149335,81,3,0,3,0,0,0,87
1149336,64,0,0,0,0,0,0,64
1149337,66,4,3,0,0,0,0,73
1149338,63,3,5,0,0,0,0,71
1149339,74,4,0,0,0,0,0,78
1149340,65,3,0,0,0,0,0,68
1149341,78,4,3,3,0,0,0,88
1149342,62,7,3,3,0,0,0,75
1149343,33,3,4,0,0,0,0,40
1149344,96,0,0,4,0,0,0,100
1149345,88,4,0,0,0,0,0,92
1149346,53,3,3,0,0,0,0,59
1149347,57,4,3,0,0,0,0,64
1149401,50,5,3,0,0,0,0,58
1149402,42,0,0,0,0,0,0,42
1149403,70,3,0,0,0,0,0,73
1149404,77,3,4,3,0,0,0,87
1149405,65,0,3,0,0,0,0,68
1149406,46,0,0,0,0,0,0,46
1149407,69,4,0,0,0,0,0,73
1149408,86,3,3,3,0,0,0,95
1149409,69,3,0,0,0,0,0,72
1149410,64,0,0,0,0,0,0,64
1149411,63,5,0,3,0,0,0,71
1149412,47,3,3,0,0,0,0,53
1149413,53,0,3,0,0,0,0,56
1149414,30,3,0,0,0,0,0,33
1149415,37,0,0,0,0,0,0,37
1149416,29,3,3,3,0,0,0,38
1149417,63,0,0,0,0,0,0,63
1149418,60,4,0,0,0,0,0,64
1149419,47,4,0,0,0,0,0,51
1149420,53,5,3,0,0,3,0,64
1149421,66,3,3,0,0,0,0,72
1149422,48,3,3,3,0,0,0,57
1149423,54,0,3,0,0,0,3,60
1149424,72,0,0,0,0,0,0,72
1149425,70,0,3,0,0,0,0,73
1149426,37,4,0,0,0,0,0,41
1149501,66,0,0,0,0,0,0,66
1149502,25,0,0,0,0,0,0,25
1149503,59,5,0,0,0,0,0,64
1149504,41,3,0,3,0,0,0,47
1149505,57,0,0,0,0,0,0,57
1149506,63,0,0,3,0,0,0,66
1149507,56,6,0,0,0,0,0,62
1149508,66,4,3,0,0,0,0,73
1149509,79,3,0,0,0,0,0,82
1149510,93,6,0,0,0,0,0,99
1149511,104,6,0,0,0,0,0,110
1149512,65,6,0,0,0,0,0,71
1149513,73,3,0,3,0,0,0,79
1149514,61,3,0,0,0,0,0,64
1149515,56,0,0,0,0,0,0,56
1149516,66,3,3,0,0,0,0,72
1149517,64,4,0,5,0,0,0,73
1149518,60,5,0,0,0,0,0,65
1149519,41,4,0,0,0,0,0,45
1149520,55,0,0,0,0,0,0,55
1149521,54,3,3,0,0,0,0,60
1149522,57,3,3,0,0,0,0,63
1149523,90,0,0,3,0,0,0,93
1149524,90,3,5,3,0,0,0,101
1149525,52,3,0,0,0,0,0,55
1149526,74,4,3,3,0,0,0,84
1149527,67,0,0,0,0,0,0,67
1149528,75,0,3,0,0,0,0,78
1149529,78,3,0,0,0,0,0,81
1149530,51,0,0,0,0,0,0,51
1149531,74,0,0,0,0,0,0,74
1149532,61,3,0,0,0,0,0,64
1149533,53,0,0,0,0,0,0,53
1149534,80,5,0,0,0,0,0,85
1149535,27,0,0,0,0,0,0,27
1149536,37,0,0,3,0,0,0,40
1149537,44,3,0,3,0,0,0,50
1149538,50,0,0,0,0,0,0,50
1149539,87,3,0,0,0,0,0,90
1149540,65,4,0,0,0,0,0,69
1149541,55,4,0,0,0,0,0,59
1149542,82,8,3,0,0,0,4,97
1149543,52,0,4,0,0,0,0,56
1149544,55,4,0,3,0,0,0,62
1149545,51,0,0,0,0,0,0,51
1149546,86,6,0,0,0,3,0,95
1149547,33,0,0,0,0,0,0,33
1149548,39,3,0,0,0,0,0,42
1149549,33,0,0,0,0,0,0,33
1149550,57,0,0,0,0,0,0,57
1149551,61,4,0,0,0,0,0,65
1149552,69,0,0,0,0,0,0,69
1149553,48,4,0,0,0,0,0,52
1149554,79,0,0,0,0,0,0,79
1149555,40,0,0,0,0,0,0,40
1149556,31,3,4,3,0,0,0,41
1149557,20,0,4,0,0,0,0,24
1149558,23,0,0,0,0,0,0,23
1149601,77,3,0,0,0,0,0,80
1149602,32,0,0,0,0,0,0,32
1149603,42,4,3,0,0,0,0,49
1149604,58,3,0,3,0,0,0,64
1149605,40,0,0,0,0,0,0,40
1149606,52,3,4,3,0,0,0,62
1149607,46,4,0,0,0,0,0,50
1149608,68,3,0,0,0,0,0,71
1149609,45,4,0,0,0,0,0,49
1149610,65,6,0,0,0,0,0,71
1149611,0,0,0,0,0,0,0,0
1149612,0,0,0,0,0,0,0,0
1149613,37,0,0,0,0,0,0,37
1149614,74,4,0,0,0,0,0,78
1149615,76,4,0,0,0,0,0,80
1149616,45,3,0,0,0,0,0,48
1149617,54,4,3,0,0,0,0,61
1149618,97,4,0,0,0,0,0,101
1149619,57,3,3,0,0,0,0,63
1149620,48,5,0,0,0,0,0,53
1149621,74,5,3,0,0,0,0,82
1149622,90,5,3,4,0,0,0,102
1149623,69,0,0,0,0,0,0,69
1149624,73,3,4,3,0,0,0,83
1149625,23,0,0,0,0,0,0,23
1149626,10,5,0,0,0,0,0,15
1149627,100,3,0,0,0,0,0,103
1149628,87,0,0,3,0,0,0,90
1149629,44,5,0,0,0,0,0,49
1149630,68,3,0,0,0,0,0,71
1149631,64,4,4,0,0,0,0,72
1149632,70,5,0,0,0,0,0,75
1149633,60,0,0,0,0,0,0,60
1149634,52,3,0,0,0,0,0,55
1149635,68,3,0,3,0,0,0,74
1149636,46,0,0,0,0,0,0,46
1149637,62,0,6,0,0,0,0,68
1149638,68,0,0,0,0,0,0,68
1149639,44,0,0,0,0,0,0,44
1149640,56,8,3,0,0,0,0,67
1149641,80,3,0,0,0,0,0,83
1149642,73,3,0,0,0,0,0,76
1149643,57,3,0,0,0,0,0,60
1149644,59,7,0,0,0,0,0,66
1149645,36,3,3,0,0,0,0,42
1149646,70,0,3,0,0,0,0,73
1149647,94,3,3,0,0,0,0,100
1149648,54,3,3,0,0,0,0,60
1149649,48,0,0,0,0,3,0,51
1149650,35,3,0,3,0,0,0,41
1149701,81,0,3,0,0,0,0,84
1149702,61,3,3,0,0,0,0,67
1149703,60,0,0,0,3,0,0,63
1149704,82,3,0,3,0,0,0,88
1149705,64,3,0,0,0,0,0,67
1149706,65,3,0,0,0,0,0,68
1149707,41,3,0,0,0,0,0,44
1149708,49,5,0,0,3,0,3,60
1149709,30,0,0,0,0,0,0,30
1149710,53,0,0,3,0,0,0,56
1149711,58,3,0,0,0,0,0,61
1149712,69,3,0,3,0,0,0,75
1149713,66,0,0,4,0,0,0,70
1149714,27,0,0,0,0,0,0,27
1149715,62,0,0,0,0,0,0,62
1149716,47,6,4,0,0,0,0,57
1149717,116,4,0,3,0,0,0,123
1149718,39,0,0,3,0,3,0,45
1149719,34,4,0,0,0,0,0,38
1149720,52,3,0,0,0,0,0,55
1149721,30,6,0,0,0,0,0,36
1149722,65,0,0,0,0,0,0,65
1149723,26,0,3,0,0,0,0,29
1149724,68,0,0,0,0,0,0,68
1149725,79,0,5,0,0,0,0,84
1149726,73,7,0,0,0,0,0,80
1149727,38,0,0,4,0,0,0,42
1149728,60,4,0,0,0,0,0,64
1149729,72,5,0,3,0,0,0,80
1149730,60,0,3,0,0,0,3,66
1149731,67,0,0,0,0,0,0,67
1149732,58,4,3,0,0,0,0,65
1149733,44,6,0,0,0,0,0,50
1149734,49,4,3,3,0,0,0,59
1149735,69,3,0,3,0,0,0,75
1149736,62,0,3,0,0,0,0,65
1149737,90,3,0,0,0,0,0,93
1149738,69,0,0,0,0,0,3,72
1149739,93,0,0,0,0,0,0,93
1149740,58,0,4,0,0,0,0,62
1149741,48,3,3,0,0,0,0,54
1149742,73,3,0,4,0,0,0,80
1149743,85,3,0,0,0,0,0,88
1149744,64,3,3,0,0,0,0,70
1149745,76,3,6,0,0,0,0,85
1149746,36,0,3,0,0,0,0,39
1149747,46,0,0,0,0,0,0,46
1149748,34,3,0,0,0,0,0,37
1149749,29,0,0,0,0,0,0,29
1149750,80,3,0,0,0,0,0,83
1149751,61,4,0,0,0,0,0,65
1149752,22,3,3,0,0,0,0,28
1149753,39,0,0,0,0,0,0,39
1149754,36,0,0,0,0,0,0,36
1149801,32,0,3,0,0,0,0,35
1149802,29,3,0,0,0,0,0,32
1149803,75,5,0,0,0,0,0,80
1149804,46,3,0,0,0,0,0,49
1149805,69,3,0,0,0,0,3,75
1149806,76,3,0,3,0,0,0,82
1149807,48,3,3,0,0,0,0,54
1149808,20,0,0,0,0,0,0,20
1149809,55,0,0,0,0,0,0,55
1149810,69,7,3,0,0,0,0,79
1149811,16,0,0,0,0,0,0,16
1149812,48,3,0,0,0,0,0,51
1149813,87,4,3,0,0,0,0,94
1149814,61,3,0,0,0,0,0,64
1149815,26,6,0,0,0,0,0,32
1149816,13,4,0,0,0,0,0,17
1149817,51,7,0,0,0,0,0,58
1149818,45,0,0,3,0,0,0,48
1149819,25,0,0,0,0,0,0,25
1149820,63,0,0,0,0,0,0,63
1149821,37,3,3,0,0,0,4,47
1149822,39,0,0,0,0,0,0,39
1149823,20,0,0,0,0,0,0,20
1149824,43,4,0,0,0,0,0,47
1149825,41,0,0,0,0,0,0,41
1149826,23,0,0,0,0,0,0,23
1149827,53,4,0,0,0,0,0,57
1149828,45,0,0,0,0,0,0,45
1149829,70,4,0,0,0,0,0,74
1149830,70,5,3,0,0,0,0,78
1149831,67,3,3,3,0,0,0,76
1149832,37,3,4,0,0,0,0,44
1149833,66,3,3,0,0,0,3,75
1149834,50,6,0,0,0,0,0,56
1149835,14,0,0,0,0,0,0,14
1149901,48,3,3,0,0,0,0,54
1149902,66,0,3,0,0,0,0,69
1149903,57,3,3,0,0,0,0,63
1149904,68,3,3,0,0,0,0,74
1149905,25,3,0,3,0,0,0,31
1149906,53,4,0,0,0,0,0,57
1149907,69,4,0,0,0,0,0,73
1149908,0,0,0,0,0,0,0,0
1149909,38,3,0,3,0,0,0,44
1149910,53,4,0,0,0,0,0,57
1149911,81,5,0,0,0,0,0,86
1149912,75,3,0,0,0,0,0,78
1149913,23,0,4,0,0,0,0,27
1149914,36,3,0,0,0,0,0,39
1149915,37,3,0,0,0,0,4,44
1149916,48,3,0,3,0,0,0,54
1149917,28,0,3,0,0,0,0,31
1149918,65,0,4,0,0,0,0,69
1149919,58,4,3,0,0,0,0,65
1149920,49,6,0,3,0,0,0,58
1149921,44,4,0,0,0,0,0,48
1149922,78,0,0,0,0,0,0,78
1149923,41,0,0,0,0,0,0,41
1149924,33,0,0,0,0,0,0,33
1150001,3,0,0,0,0,0,0,3
1150002,0,0,0,0,0,0,0,0
1150003,73,3,0,4,0,0,0,80
1150004,21,3,0,0,0,0,0,24
1150005,24,0,0,0,0,0,0,24
1150006,63,3,0,0,0,0,0,66
1150007,38,0,0,0,0,0,0,38
1150008,20,3,0,0,0,0,0,23
1150009,47,3,0,0,0,0,0,50
1150010,67,3,0,0,0,0,0,70
1150011,102,3,3,3,0,0,0,111
1150012,32,0,0,0,0,0,0,32
1150013,68,4,0,5,0,0,0,77
1150014,27,0,0,0,0,0,0,27
1150015,50,5,3,0,0,0,0,58
1150016,41,3,0,0,0,0,0,44
1150017,56,3,0,0,0,0,0,59
1150018,53,0,0,3,0,0,0,56
1150019,69,0,3,0,0,0,0,72
1150020,32,0,4,0,0,0,0,36
1150021,7,4,0,0,0,0,0,11
1150022,0,0,0,0,0,0,0,0
1150023,17,0,0,0,0,0,0,17
1150024,0,0,0,0,0,0,0,0
1150025,56,3,3,3,0,0,0,65
1150026,25,0,0,0,0,0,4,29
1150027,25,0,0,0,0,0,0,25
1150028,40,0,0,0,0,0,0,40
1150029,21,3,0,0,0,0,0,24
1150030,39,4,0,0,0,0,0,43
1150031,50,3,0,0,0,0,0,53
1150032,41,0,3,0,0,0,0,44
1150033,65,3,0,0,0,0,0,68
1150034,39,3,0,0,0,0,0,42
1150035,33,0,0,0,0,0,0,33
1150036,66,0,0,4,0,0,0,70
1150037,34,3,0,0,0,0,0,37
1150038,15,3,0,0,0,0,0,18
1150039,31,3,0,0,0,0,0,34
1150040,25,0,0,0,0,0,0,25
1150041,33,4,0,0,0,0,0,37
1150042,19,0,0,0,0,0,0,19
1150043,44,4,0,4,0,0,0,52
1150101,64,3,0,0,0,0,0,67
1150102,64,4,0,0,0,4,0,72
1150103,47,0,0,0,0,0,0,47
1150104,77,0,0,0,0,0,0,77
1150105,74,3,0,3,0,0,0,80
1150106,49,3,0,0,0,0,0,52
1150107,81,6,0,0,0,0,0,87
1150108,45,4,0,0,0,0,0,49
1150109,60,0,0,0,0,0,0,60
1150110,58,3,0,3,0,0,0,64
1150111,53,0,3,0,0,0,0,56
1150112,35,0,0,0,0,0,0,35
1150113,47,9,0,0,0,0,0,56
1150114,0,0,0,0,0,0,0,0
1150115,81,4,0,0,0,0,0,85
1150116,60,3,0,0,0,0,0,63
1150117,40,3,0,0,0,0,0,43
1150118,52,3,0,0,0,0,0,55
1150119,0,0,0,0,0,0,0,0
1150120,28,5,0,0,0,0,0,33
1150121,60,0,0,0,0,0,0,60
1150122,66,3,0,0,0,0,0,69
1150123,78,3,3,0,0,0,0,84
1150124,57,5,3,0,0,0,0,65
1150125,0,0,0,0,0,0,0,0
1150126,30,3,0,3,0,0,0,36
1150127,3,0,0,0,0,0,0,3
1150128,68,0,0,4,0,0,0,72
1150129,45,3,0,0,0,0,0,48
1150130,57,7,0,0,0,0,0,64
1150131,66,3,0,0,0,0,0,69
1150132,65,3,0,0,0,0,0,68
1150201,44,9,0,0,0,0,0,53
1150202,25,3,0,0,0,0,0,28
1150203,84,5,5,0,0,0,0,94
1150204,71,0,0,0,0,3,0,74
1150205,53,4,0,0,0,0,0,57
1150206,50,3,0,0,0,0,0,53
1150207,69,0,0,0,0,0,0,69
1150208,41,8,0,0,0,0,0,49
1150209,45,0,0,0,0,0,0,45
1150210,33,4,0,0,0,5,0,42
1150211,38,0,0,0,0,0,0,38
1150212,77,3,0,0,0,0,0,80
1150213,34,4,0,0,0,0,0,38
1150214,37,5,0,0,0,0,0,42
1150215,76,0,0,0,0,0,0,76
1150216,43,0,0,0,0,0,0,43
1150217,44,4,0,0,0,0,0,48
1150218,47,0,0,0,0,0,0,47
1150219,49,4,0,0,0,0,0,53
1150220,70,0,0,0,0,0,0,70
1150221,36,4,0,0,0,0,0,40
1150222,47,3,0,0,0,0,0,50
1150223,53,0,0,0,0,0,0,53
1150224,0,0,0,0,0,0,0,0
1150225,47,4,3,0,0,0,0,54
1150226,35,3,0,0,0,0,0,38
1150227,75,4,3,3,0,0,0,85
1150228,63,5,3,0,0,0,0,71
1150229,52,3,0,0,0,0,0,55
1150230,74,4,0,0,0,0,0,78
1150231,73,3,0,0,0,0,0,76
1150232,75,3,3,0,0,0,0,81
1150233,32,0,3,3,0,0,0,38
1150234,67,3,0,5,0,0,0,75
1150235,52,3,0,0,0,0,0,55
1150236,36,0,0,0,0,0,0,36
1150237,80,4,0,0,0,0,3,87
1150238,89,9,0,0,0,0,0,98
1150239,101,3,0,0,0,0,0,104
1150240,73,0,5,0,0,0,0,78
1150241,71,0,0,0,0,0,0,71
1150242,57,3,5,0,0,0,0,65
1150243,34,0,0,0,0,0,0,34
1150244,71,3,0,0,0,0,0,74
1150245,94,3,3,0,0,0,0,100
1150246,75,4,4,0,0,0,0,83
1150247,92,3,3,4,0,0,0,102
1150248,46,3,0,0,0,0,0,49
1150249,32,0,0,0,0,0,0,32
1150250,46,0,0,0,0,0,0,46
1150251,54,0,0,0,0,0,0,54
1150252,84,3,0,0,0,0,0,87
1150253,136,3,3,0,0,0,0,142
1150254,63,8,3,0,0,0,0,74
1150255,43,0,0,0,0,0,0,43
1150256,82,5,0,0,0,0,0,87
1150257,75,3,3,0,0,0,0,81
1150301,18,0,0,0,0,0,0,18
1150302,23,0,0,0,0,0,0,23
1150303,61,5,0,0,0,0,0,66
1150304,58,3,4,0,0,0,0,65
1150305,49,3,0,0,0,0,0,52
1150306,58,0,0,0,0,0,0,58
1150307,62,8,0,0,0,0,0,70
1150308,64,3,3,0,0,0,0,70
1150309,77,12,3,0,0,0,0,92
1150310,35,0,0,0,0,0,0,35
1150311,55,0,0,4,0,0,0,59
1150312,69,3,0,0,0,0,0,72
1150313,25,3,0,0,0,0,0,28
1150314,59,0,0,0,0,0,0,59
1150315,60,0,0,0,0,0,0,60
1150316,48,3,0,0,0,0,0,51
1150317,16,0,3,0,0,0,0,19
1150318,25,0,0,3,0,0,0,28
1150319,49,3,0,0,0,0,0,52
1150320,69,0,0,0,0,0,0,69
1150321,25,0,0,0,0,0,0,25
1150322,44,4,4,0,0,0,0,52
1150323,66,3,3,3,0,0,0,75
1150324,46,3,0,0,0,0,0,49
1150325,30,0,0,0,0,0,0,30
1150326,26,3,0,0,0,0,0,29
1150327,53,3,3,3,0,0,0,62
1150328,59,0,3,3,0,0,0,65
1150329,0,0,0,0,0,0,0,0
1150330,33,0,0,0,0,0,0,33
1150331,16,0,3,3,0,0,0,22
1150332,106,8,5,0,0,0,0,119
1150333,84,3,0,0,0,0,0,87
1150334,46,0,0,0,0,0,0,46
1150335,69,3,0,0,0,4,0,76
1150336,69,9,0,0,0,0,0,78
1150337,65,4,0,0,0,0,0,69
1150338,68,0,0,3,0,0,0,71
1150401,62,9,5,0,0,0,0,76
1150402,35,0,0,4,0,0,0,39
1150403,46,6,5,0,0,0,3,60
1150404,33,0,0,0,0,0,0,33
1150405,23,0,0,3,0,0,0,26
1150406,67,0,4,0,0,0,0,71
1150407,48,0,3,0,0,0,3,54
1150408,33,3,3,0,0,0,0,39
1150409,36,3,0,0,0,0,0,39
1150410,35,3,0,0,0,0,0,38
1150411,44,5,0,3,0,0,0,52
1150412,41,3,0,0,0,0,0,44
1150413,44,4,0,0,0,0,0,48
1150414,33,0,3,0,0,0,0,36
1150415,39,5,0,0,0,0,0,44
1150416,3,0,0,0,0,0,0,3
1150417,35,0,0,8,0,3,0,46
1150418,54,0,3,0,0,0,0,57
1150419,40,10,0,0,0,0,0,50
1150420,42,0,3,0,0,0,3,48
1150421,14,0,0,0,0,0,3,17
1150422,56,4,3,0,0,0,0,63
1150423,40,3,3,0,0,0,0,46
1150424,64,4,3,0,0,0,0,71
1150425,40,3,3,0,3,0,0,49
1150426,35,0,0,0,0,0,4,39
1150427,22,0,0,0,0,0,0,22
1150428,53,5,0,0,0,0,0,58
1150429,52,0,0,0,0,0,0,52
1150430,34,4,3,0,0,0,0,41
1150431,0,0,0,0,0,0,0,0
1150432,20,0,4,0,0,0,0,24
1150433,23,6,5,0,0,0,0,34
1150434,40,3,3,0,3,0,0,49
1150435,21,0,3,0,0,0,0,24
1150436,14,3,3,0,0,0,0,20
1150437,21,0,4,3,0,0,0,28
1150438,71,4,10,4,0,0,0,89
1150439,46,5,3,5,0,0,0,59
1150440,36,4,0,0,0,0,0,40
1150441,46,0,0,0,0,0,3,49
1150501,48,7,3,0,0,0,0,58
1150502,42,0,0,3,0,0,0,45
1150503,29,0,4,0,0,0,0,33
1150504,71,3,5,0,0,0,0,79
1150505,61,5,4,0,0,0,0,70
1150506,44,4,0,0,0,0,0,48
1150507,31,3,5,0,0,0,0,39
1150508,43,0,0,0,0,0,0,43
1150509,69,8,4,0,0,0,0,81
1150510,58,3,3,3,0,0,0,67
1150511,74,5,0,0,0,3,0,82
1150512,57,0,0,0,0,0,0,57
1150513,50,3,3,0,0,0,0,56
1150514,42,0,0,4,0,0,0,46
1150515,39,3,3,3,0,0,3,51
1150516,63,7,4,0,0,0,0,74
1150517,31,3,3,0,0,0,0,37
1150518,63,4,0,0,0,0,0,67
1150519,114,3,3,3,0,0,0,123
1150520,97,4,3,0,0,0,3,107
1150521,41,3,0,0,0,0,0,44
1150522,39,3,0,3,0,0,0,45
1150601,41,4,4,0,0,0,0,49
1150602,20,3,0,0,0,0,0,23
1150603,47,3,0,0,0,0,0,50
1150604,69,3,0,0,0,0,0,72
1150605,88,3,4,0,0,0,0,95
1150606,50,0,0,0,0,0,0,50
1150607,13,0,0,0,0,0,0,13
1150608,7,3,0,0,0,0,0,10
1150609,47,0,4,0,0,0,0,51
1150610,41,4,0,0,0,0,0,45
1150611,48,3,3,0,0,0,0,54
1150612,54,0,0,0,0,3,0,57
1150613,41,3,3,3,0,0,0,50
1150614,46,3,0,0,0,0,0,49
1150615,34,0,0,0,0,0,0,34
1150616,31,10,6,0,0,0,0,47
1150617,37,5,0,0,0,0,0,42
1150618,63,3,0,3,0,0,3,72
1150701,81,7,3,3,3,0,0,97
1150702,39,0,0,0,0,0,0,39
1150703,72,4,0,0,0,0,0,76
1150704,60,3,0,0,0,0,0,63
1150705,18,4,0,0,0,0,0,22
1150706,41,3,0,0,0,0,0,44
1150707,0,0,0,0,0,0,0,0
1150708,58,5,0,0,0,0,0,63
1150709,52,0,0,0,0,0,0,52
1150710,88,6,0,0,0,0,0,94
1150711,31,0,3,0,0,0,3,37
1150712,52,3,0,0,0,0,0,55
1150713,91,0,3,0,0,0,0,94
1150714,76,3,3,3,0,0,0,85
1150715,76,0,0,0,0,0,0,76
1150716,94,0,0,0,0,0,0,94
1150717,63,7,0,0,0,0,0,70
1150718,92,0,0,0,0,0,0,92
1150719,67,0,3,0,0,0,0,70
1150720,61,0,3,3,0,0,0,67
1150721,86,8,4,5,0,0,0,103
1150722,60,3,0,3,0,0,0,66
1150723,66,0,0,3,0,0,0,69
1150724,87,4,3,3,0,0,0,97
1150725,80,3,3,0,0,0,0,86
1150726,51,4,0,0,0,0,0,55
1150727,79,3,3,0,0,0,0,85
1150728,55,8,3,3,0,0,0,69
1150729,107,6,3,3,0,0,0,119
1150730,24,0,0,0,0,0,0,24
1150731,48,0,3,0,0,0,0,51
1150732,37,0,0,0,0,0,0,37
1150733,37,5,0,0,0,0,0,42
1150734,48,3,0,0,0,0,0,51
1150735,78,3,0,0,0,0,0,81
1150736,68,4,5,0,0,0,0,77
1150737,50,0,0,3,0,0,0,53
1150738,37,0,0,0,0,0,0,37
1150739,60,8,0,3,0,0,0,71
1150740,71,4,3,0,0,0,0,78
1150741,64,3,3,3,0,0,0,73
1150742,55,6,0,0,0,0,0,61
1150743,47,0,4,0,0,0,0,51
1150744,47,0,0,0,0,0,0,47
1150745,70,4,0,3,0,0,0,77
1150746,41,4,0,4,0,0,0,49
1150747,66,3,0,3,0,0,0,72
1150748,86,4,3,3,0,0,3,99
1150749,46,5,3,4,0,0,0,58
1150750,77,4,3,0,0,0,0,84
1150751,53,3,0,0,0,0,0,56
1150752,77,3,3,3,0,0,0,86
1150753,77,0,4,0,0,3,0,84
1150754,66,3,3,0,0,0,0,72
1150755,70,3,3,0,0,0,0,76
1150756,53,0,3,0,0,0,0,56
1150757,47,0,3,0,0,0,0,50
1150758,83,3,3,3,0,0,0,92
1150759,78,4,3,0,0,0,0,85
1150760,39,0,0,0,0,0,0,39
1150761,59,3,6,0,0,0,0,68
1150762,43,3,3,0,0,0,0,49
1150763,58,0,0,5,3,0,0,66
1150764,51,4,3,0,0,0,0,58
1150765,106,0,4,0,0,0,0,110
1150766,48,4,0,5,0,0,0,57
1150767,73,3,3,5,0,0,0,84
1150768,53,3,0,3,0,0,0,59
1150769,44,0,0,5,0,0,0,49
1150770,99,4,4,0,0,0,0,107
1150771,45,4,3,0,0,0,0,52
1150801,67,4,3,0,0,0,0,74
1150802,139,4,0,0,0,0,0,143
1150803,127,7,0,0,0,0,0,134
1150804,53,0,0,0,0,0,0,53
1150805,81,9,3,0,0,0,0,93
1150806,63,8,3,0,0,3,0,77
1150807,86,3,3,3,0,0,0,95
1150808,78,6,0,5,0,0,0,89
1150809,75,3,3,0,0,0,0,81
1150810,75,4,4,0,0,0,0,83
1150811,100,0,0,0,0,0,0,100
1150812,110,8,3,0,0,0,3,124
1150813,100,4,0,0,0,0,0,104
1150814,95,5,0,0,0,0,0,100
1150815,43,0,4,0,0,0,0,47
1150816,62,5,0,0,0,0,0,67
1150817,58,6,3,0,0,3,0,70
1150818,55,0,0,0,0,0,0,55
1150819,56,5,4,0,0,0,0,65
1150820,74,3,3,3,0,0,0,83
1150821,80,0,4,5,0,0,0,89
1150822,38,4,4,0,0,0,0,46
1150823,63,0,4,0,0,0,0,67
1150824,59,0,3,4,0,0,0,66
1150825,56,0,0,0,0,0,0,56
1150826,74,5,3,3,0,0,0,85
1150827,69,0,4,3,0,0,0,76
1150828,102,5,0,0,0,0,0,107
1150829,76,3,0,3,0,0,0,82
1150830,64,4,3,0,0,0,0,71
1150831,65,0,5,0,0,0,0,70
1150832,160,8,6,0,0,0,0,174
1150833,83,0,0,0,0,0,0,83
1150834,63,3,3,3,0,0,0,72
1150835,32,0,3,0,0,0,5,40
1150836,77,5,0,0,0,0,0,82
1150837,56,4,4,0,0,0,0,64
1150838,50,7,0,0,0,0,0,57
1150839,70,11,3,0,0,0,0,84
1150901,28,3,3,0,0,0,0,34
1150902,82,6,0,6,0,0,4,98
1150903,75,0,4,0,0,0,0,79
1150904,64,3,0,3,0,0,0,70
1150905,57,4,4,3,0,0,0,68
1150906,82,3,0,0,0,0,0,85
1150907,72,0,0,5,0,0,0,77
1150908,73,5,0,0,0,0,0,78
1150909,100,6,3,0,0,0,0,109
1150910,63,3,0,0,0,0,0,66
1150911,63,10,0,0,0,0,0,73
1150912,64,0,0,0,0,0,0,64
1150913,67,3,3,5,0,0,3,81
1150914,54,3,0,0,0,0,0,57
1150915,89,0,3,0,0,0,0,92
1150916,46,0,0,3,0,0,0,49
1150917,44,3,0,0,0,0,0,47
1150918,49,3,0,3,0,0,0,55
1150919,97,0,0,3,0,0,0,100
1150920,109,0,0,4,0,0,0,113
1150921,39,5,0,0,0,0,0,44
1150922,71,3,0,0,0,0,0,74
1150923,52,0,0,3,0,0,4,59
1150924,55,5,0,0,0,0,0,60
1150925,70,5,3,3,0,0,3,84
1150926,39,0,0,0,0,0,0,39
1150927,39,3,3,0,0,0,3,48
1150928,0,0,0,0,0,0,0,0
1150929,53,10,3,0,0,0,0,66
1150930,45,5,0,0,0,0,0,50
1150931,22,3,4,0,0,0,0,29
1150932,30,3,3,0,0,0,0,36
1150933,56,3,0,3,0,0,0,62
1150934,17,3,0,0,0,0,0,20
1150935,38,3,0,0,0,0,0,41
1150936,37,7,0,3,0,0,0,47
1151001,69,4,0,0,0,0,4,77
1151002,44,5,0,0,0,0,0,49
1151003,42,0,3,0,0,0,0,45
1151004,66,0,0,0,0,0,0,66
1151005,81,7,0,3,0,0,0,91
1151006,93,0,3,3,0,0,0,99
1151007,77,0,0,0,0,0,3,80
1151008,51,0,0,0,0,0,0,51
1151009,53,3,4,0,3,0,0,63
1151010,36,0,3,0,0,0,0,39
1151011,47,4,0,0,0,0,0,51
1151012,47,4,0,0,0,0,0,51
1151013,55,3,3,0,0,0,0,61
1151014,73,3,0,3,0,0,0,79
1151015,41,6,0,0,0,0,0,47
1151016,54,3,0,0,0,0,0,57
1151017,64,4,3,0,0,0,0,71
1151018,83,3,0,0,0,0,0,86
1151019,83,3,0,3,0,0,0,89
1151020,37,0,0,0,0,0,0,37
1151021,50,0,0,0,0,0,0,50
1151022,50,0,0,0,0,0,3,53
1151023,0,0,0,0,0,0,0,0
1151024,80,4,0,0,0,0,0,84
1151025,0,0,0,0,0,0,0,0
1151026,47,0,0,0,0,0,0,47
1151027,40,0,0,3,0,0,0,43
1151028,27,4,0,0,0,0,0,31
1151029,54,4,0,0,0,0,0,58
1151030,80,0,0,0,0,0,0,80
1151031,64,3,0,3,0,0,0,70
1151032,46,4,0,0,0,0,0,50
1151033,73,5,0,5,0,0,0,83
1151034,65,3,3,0,0,0,0,71
1151035,48,0,0,0,0,0,0,48
1151036,92,0,0,0,0,0,0,92
1151037,73,0,0,0,0,0,3,76
1151038,56,4,0,0,0,0,0,60
1151039,61,4,0,3,0,0,0,68
1151040,41,3,3,0,0,0,0,47
1151041,48,5,3,0,0,0,0,56
1151042,60,3,4,0,0,0,0,67
1151043,41,0,0,0,0,0,0,41
1151044,84,3,0,3,0,0,0,90
1151045,93,7,3,3,0,0,0,106
1151046,57,8,0,0,0,0,0,65
1151047,67,3,3,0,0,0,0,73
1151048,72,0,0,3,0,0,0,75
1151049,48,0,4,0,0,0,0,52
1151101,41,3,5,3,3,0,0,55
1151102,0,0,0,0,0,0,0,0
1151103,43,4,4,0,0,0,0,51
1151104,32,0,0,0,0,0,0,32
1151105,18,0,3,0,0,0,0,21
1151106,56,4,0,0,0,0,0,60
1151107,52,0,0,0,0,0,0,52
1151108,69,3,0,3,0,0,0,75
1151109,18,3,0,0,0,0,0,21
1151110,47,4,3,0,0,0,0,54
1151111,66,4,5,3,0,0,0,78
1151112,64,0,3,4,0,0,0,71
1151113,52,7,0,0,0,0,0,59
1151114,47,5,0,3,0,0,0,55
1151115,60,3,4,3,0,0,3,73
1151116,43,3,0,4,0,4,0,54
1151117,52,9,3,0,0,0,0,64
1151118,41,9,0,3,0,0,0,53
1151119,31,7,0,0,0,0,0,38
1151120,40,3,0,0,0,0,0,43
1151121,30,6,0,0,0,0,0,36
1151122,77,6,3,0,0,0,0,86
1151123,19,3,0,0,0,0,3,25
1151124,27,3,0,3,0,0,0,33
1151125,38,3,0,3,0,0,0,44
1151126,42,3,3,0,0,0,0,48
1151127,31,5,3,3,0,0,0,42
1151128,46,6,0,0,0,0,0,52
1151129,29,7,0,0,0,0,0,36
1151130,40,9,0,0,0,0,0,49
1151131,12,3,3,0,0,3,0,21
1151132,29,7,3,3,0,0,0,42
1151133,27,0,0,3,0,0,0,30
1151134,63,4,3,0,0,0,0,70
1151135,54,3,3,0,0,0,0,60
1151136,71,3,3,0,0,3,0,80
1151137,72,5,4,0,0,0,0,81
1151138,46,3,4,0,0,0,0,53
1151139,60,3,0,0,0,0,0,63
1151140,25,0,3,0,0,0,0,28
1151141,76,0,0,10,0,0,0,86
1151142,22,5,0,0,0,0,0,27
1151143,54,6,3,3,0,0,0,66
1151144,50,3,3,0,0,0,0,56
1151145,25,0,0,0,0,0,0,25
1151146,29,3,0,0,0,0,4,36
1151147,34,3,0,0,0,0,4,41
1151148,43,9,3,3,0,0,0,58
1151149,55,4,3,0,0,0,0,62
1151150,72,6,0,5,0,0,0,83
1151151,34,0,0,0,0,0,0,34
1151152,35,0,0,0,0,0,0,35
1151153,30,3,0,4,0,0,0,37
1151154,63,3,3,3,0,0,0,72
1151155,54,5,3,0,0,0,0,62
1151156,21,5,0,5,0,0,0,31
1151201,15,3,3,0,0,0,0,21
1151202,42,3,0,0,0,0,0,45
1151203,37,0,3,0,0,0,0,40
1151204,68,3,3,3,0,0,0,77
1151205,50,4,0,0,0,0,0,54
1151206,44,4,0,0,0,0,0,48
1151207,39,0,3,0,0,0,0,42
1151208,28,0,0,0,0,0,0,28
1151209,39,0,3,0,0,0,0,42
1151210,44,4,0,4,0,0,0,52
1151211,72,4,0,0,0,0,0,76
1151212,56,0,3,3,0,0,0,62
1151213,50,4,6,0,0,0,0,60
1151214,36,3,0,3,0,0,0,42
1151215,53,3,6,3,0,0,0,65
1151216,42,5,4,0,0,0,0,51
1151217,37,0,4,0,0,0,0,41
1151218,69,4,0,0,0,0,0,73
1151219,46,5,3,0,0,0,0,54
1151220,64,3,7,0,0,0,0,74
1151221,53,4,3,0,0,0,3,63
1151222,45,6,0,3,0,0,0,54
1151223,69,3,0,4,0,0,0,76
1151224,39,4,3,3,0,0,0,49
1151225,46,3,0,3,0,0,0,52
1151226,54,7,3,0,0,0,0,64
1151227,45,3,3,5,0,0,0,56
1151228,49,3,3,0,0,0,0,55
1151229,67,6,3,3,0,0,0,79
1151230,49,0,4,5,0,0,0,58
1151231,45,3,0,0,0,0,0,48
1151232,61,0,0,4,0,0,0,65
1151233,38,0,3,0,0,0,0,41
1151234,42,3,0,0,0,0,4,49
1151235,52,4,0,0,0,0,0,56
1151236,34,0,0,0,0,0,0,34
1151237,42,0,0,0,0,0,0,42
1151301,44,0,5,0,0,0,0,49
1151302,32,3,0,0,0,0,0,35
1151303,22,3,0,3,0,0,0,28
1151304,44,3,0,0,0,0,0,47
1151305,29,0,0,0,0,0,0,29
1151306,56,5,0,5,0,0,4,70
1151307,41,10,3,0,0,0,0,54
1151308,76,4,0,3,0,0,0,83
1151309,56,8,0,0,0,0,0,64
1151310,58,0,0,3,0,0,0,61
1151311,56,3,3,3,0,0,0,65
1151312,37,4,3,0,0,0,0,44
1151313,40,0,4,0,0,0,0,44
1151314,51,5,0,4,0,0,0,60
1151315,53,14,0,0,0,0,0,67
1151316,50,5,3,0,0,0,0,58
1151317,21,3,0,3,0,0,0,27
1151318,55,3,3,3,0,0,0,64
1151319,45,3,0,4,0,0,0,52
1151320,56,5,0,5,0,0,0,66
1151321,34,0,0,0,0,0,0,34
1151322,43,12,3,0,0,0,0,58
1151323,39,5,0,3,0,0,3,50
1151324,29,0,0,0,0,0,0,29
1151325,41,0,0,6,0,0,0,47
1151326,66,4,5,4,0,0,0,79
1151327,25,5,3,3,0,0,0,36
1151328,40,3,3,3,0,0,0,49
1151329,33,4,0,4,0,0,0,41
1151330,28,0,3,4,0,0,0,35
1151331,58,4,0,0,0,0,0,62
1151332,56,3,0,0,0,0,0,59
1151333,35,3,3,0,0,0,0,41
1151334,38,0,5,4,0,0,0,47
1151335,73,0,0,3,0,3,0,79
1151336,62,3,7,3,0,0,0,75
1151337,62,3,3,0,0,0,3,71
1151338,54,3,0,3,0,0,0,60
1151339,47,0,4,0,0,0,0,51
1151340,30,0,0,3,0,0,3,36
1151341,35,4,0,0,0,0,0,39
1151342,88,11,0,3,0,0,0,102
1151343,54,0,5,0,0,0,0,59
1151344,47,7,0,0,0,0,0,54
1151345,37,3,0,3,0,0,0,43
1151346,14,3,3,3,0,0,0,23
1151347,27,0,0,0,0,0,0,27
1151348,32,4,0,3,0,0,0,39
1151401,39,3,3,0,0,0,0,45
1151402,62,4,0,0,0,0,0,66
1151403,76,3,0,3,0,0,0,82
1151404,35,3,0,0,0,0,0,38
1151405,81,4,0,0,0,0,0,85
1151406,70,5,0,0,0,0,0,75
1151407,94,3,3,0,0,0,0,100
1151408,60,4,0,3,0,0,0,67
1151409,45,0,0,0,0,0,3,48
1151410,67,0,4,0,0,4,0,75
1151411,26,3,0,3,0,0,0,32
1151412,78,3,0,0,0,0,0,81
1151413,70,3,0,0,0,0,3,76
1151414,74,3,3,0,0,0,0,80
1151415,58,0,3,0,0,0,0,61
1151416,77,0,7,0,0,0,0,84
1151417,97,0,0,0,0,0,4,101
1151418,74,4,0,0,0,0,0,78
1151419,60,0,3,0,0,0,0,63
1151420,64,0,3,0,0,0,0,67
1151421,66,0,0,0,0,0,0,66
1151422,61,0,0,3,0,0,0,64
1151501,38,0,3,0,0,0,0,41
1151502,55,4,3,0,0,0,0,62
1151503,37,5,0,0,0,0,0,42
1151504,73,3,3,0,0,0,0,79
1151505,38,0,0,0,0,0,0,38
1151506,29,6,0,0,0,0,0,35
1151507,33,3,0,0,0,3,0,39
1151508,26,0,0,0,0,0,0,26
1151509,59,5,3,0,0,0,0,67
1151510,38,0,0,0,0,0,0,38
1151511,36,0,3,0,0,0,0,39
1151512,61,0,0,0,0,0,3,64
1151513,35,0,0,3,0,0,0,38
1151514,32,3,3,0,0,0,0,38
1151515,65,0,0,0,0,0,0,65
1151516,44,3,0,0,0,0,0,47
1151517,59,5,0,0,0,0,0,64
1151518,32,3,0,0,0,0,0,35
1151519,37,3,3,0,0,0,0,43
1151520,65,0,4,0,0,0,0,69
1151521,38,4,3,0,0,0,0,45
1151522,39,5,0,0,0,0,0,44
1151523,49,0,0,4,0,0,0,53
1151524,35,0,0,0,0,0,0,35
1151525,32,3,0,0,0,0,0,35
1151526,43,0,3,0,0,0,0,46
1151527,43,0,0,0,0,0,0,43
1151528,54,4,0,0,0,0,0,58
1151529,62,0,0,0,0,0,0,62
1151530,29,0,0,0,0,0,0,29
1151531,59,5,0,3,0,0,0,67
1151532,50,4,0,0,0,0,4,58
1151533,63,4,4,0,0,0,0,71
1151534,96,3,5,3,0,0,0,107
1151535,36,0,0,4,0,0,0,40
1151536,41,3,0,0,0,0,0,44
1151537,39,0,0,0,0,0,0,39
1151538,46,4,0,4,0,0,0,54
1151539,32,0,0,0,0,0,0,32
1151540,26,3,0,0,0,0,0,29
1151541,67,3,3,3,0,0,0,76
1151542,44,0,3,0,0,0,0,47
1151543,65,3,0,0,0,0,0,68
1151544,73,3,0,0,0,0,0,76
1151601,55,4,0,0,0,0,0,59
1151602,59,5,0,0,0,0,0,64
1151603,87,5,3,0,0,0,0,95
1151604,42,6,3,3,0,0,3,57
1151605,68,12,0,0,0,0,0,80
1151606,40,3,0,3,0,0,0,46
1151607,58,4,3,0,0,0,0,65
1151608,62,0,4,7,0,0,0,73
1151609,45,5,0,0,3,0,0,53
1151610,56,8,0,0,0,0,0,64
1151611,55,4,4,0,3,0,0,66
1151612,61,8,0,0,0,0,0,69
1151613,57,4,3,0,0,0,0,64
1151614,79,3,3,3,0,0,0,88
1151615,54,3,3,0,0,0,0,60
1151616,40,0,3,3,0,0,0,46
1151617,36,3,0,0,0,3,0,42
1151618,68,0,0,0,0,0,0,68
1151619,61,4,3,4,0,0,0,72
1151620,60,0,3,0,0,0,0,63
1151621,80,3,0,3,0,0,0,86
1151622,63,0,3,3,0,0,0,69
1151623,50,3,3,3,0,3,0,62
1151624,54,8,0,5,0,0,0,67
1151625,79,4,4,0,0,0,0,87
1151626,73,3,0,0,0,0,0,76
1151627,58,0,4,0,0,0,0,62
1151628,52,3,3,0,0,0,0,58
1151629,40,0,0,0,0,0,0,40
1151630,47,0,0,0,0,0,0,47
1151631,56,0,0,0,0,0,0,56
1151632,29,4,0,0,0,0,0,33
1151633,53,5,0,0,0,0,0,58
1151634,58,3,3,3,0,3,0,70
1151635,65,0,3,0,0,0,0,68
1151636,29,3,0,3,0,0,0,35
1151637,37,4,3,3,0,0,0,47
1151638,57,3,3,3,0,0,0,66
1151701,53,0,0,0,0,0,0,53
1151702,58,0,0,0,0,0,3,61
1151703,40,3,3,0,0,0,0,46
1151704,90,5,0,0,0,0,0,95
1151705,75,3,3,3,0,0,0,84
1151706,46,0,3,0,0,0,0,49
1151707,43,4,0,4,0,0,0,51
1151708,62,0,0,3,0,0,0,65
1151709,80,0,3,0,0,0,4,87
1151710,55,4,0,4,0,0,0,63
1151711,66,6,3,0,0,0,0,75
1151712,81,4,3,3,0,0,0,91
1151713,61,0,3,0,0,0,0,64
1151714,44,0,0,0,0,0,0,44
1151715,49,3,0,0,0,0,0,52
1151716,0,0,0,0,0,0,0,0
1151717,67,3,3,0,0,0,0,73
1151718,34,3,0,3,0,0,0,40
1151719,48,0,3,0,0,0,0,51
1151720,36,3,0,0,0,0,0,39
1151721,30,3,0,0,0,0,0,33
1151801,54,0,4,0,0,0,0,58
1151802,58,0,5,0,0,0,0,63
1151803,67,3,0,0,0,0,0,70
1151804,49,0,0,0,0,0,0,49
1151805,66,4,0,0,0,0,0,70
1151806,64,0,0,3,0,0,0,67
1151807,41,3,3,0,0,0,0,47
1151808,29,3,0,0,0,0,0,32
1151809,23,0,0,0,0,0,0,23
1151810,38,0,0,0,0,0,0,38
1151811,72,3,3,0,0,0,0,78
1151812,47,0,0,0,0,0,0,47
1151901,68,4,3,0,0,0,0,75
1151902,65,0,3,3,3,0,0,74
1151903,57,0,0,3,0,0,3,63
1151904,70,6,0,3,0,0,0,79
1151905,90,7,4,0,0,0,0,101
1151906,73,5,0,0,0,0,0,78
1151907,47,3,0,3,0,0,0,53
1151908,30,0,0,0,0,0,0,30
1151909,59,4,0,3,0,0,0,66
1151910,46,3,0,0,0,0,0,49
1151911,45,0,0,0,0,0,3,48
1151912,72,3,0,0,0,0,0,75
1151913,39,3,0,0,0,0,0,42
1151914,67,3,0,0,0,0,3,73
1151915,33,0,0,3,0,0,0,36
1151916,32,0,0,4,0,0,0,36
1151917,37,0,0,0,0,0,0,37
1151918,48,4,0,0,0,0,0,52
1151919,82,4,0,0,0,0,3,89
1151920,79,3,0,3,0,0,0,85
1151921,55,4,0,0,0,0,0,59
1151922,30,0,4,3,0,0,0,37
1151923,88,0,3,0,0,0,0,91
1151924,36,3,0,0,0,0,0,39
1151925,73,4,4,0,0,0,0,81
1151926,41,6,3,0,0,0,0,50
1151927,32,0,0,0,0,0,0,32
1151928,57,0,6,4,0,0,0,67
1151929,33,4,3,0,0,0,0,40
1151930,58,4,0,0,0,0,0,62
1151931,32,0,0,0,0,0,0,32
1151932,41,3,3,0,0,3,0,50
1151933,67,3,0,0,3,0,0,73
1151934,50,3,3,0,0,0,0,56
1151935,32,0,0,0,0,0,3,35
1151936,35,0,3,0,0,0,0,38
1151937,57,3,3,0,0,0,0,63
1151938,76,3,0,0,0,0,0,79
1151939,57,3,0,3,0,0,0,63
1151940,0,0,0,0,0,0,0,0
1152001,68,3,3,0,0,0,0,74
1152002,77,3,0,0,0,0,0,80
1152003,51,3,3,0,0,0,0,57
1152004,77,5,0,0,0,0,0,82
1152005,40,3,3,0,0,0,0,46
1152006,36,3,3,0,0,0,0,42
1152007,32,0,0,0,0,3,3,38
1152008,43,0,0,3,0,0,0,46
1152009,66,3,0,3,0,0,0,72
1152010,69,0,3,0,0,0,0,72
1152011,59,3,3,0,0,0,0,65
1152012,45,0,3,0,0,0,0,48
1152013,36,5,0,0,0,0,0,41
1152014,45,0,3,0,0,0,0,48
1152015,48,0,4,0,0,0,0,52
1152016,39,5,4,4,0,0,0,52
1152017,70,4,4,0,0,0,0,78
1152018,53,3,0,0,0,0,0,56
1152019,59,0,0,3,0,0,0,62
1152020,81,0,0,0,0,0,0,81
1152021,81,3,3,0,0,0,0,87
1152022,67,6,3,0,0,0,0,76
1152023,59,0,0,0,0,0,0,59
1152024,98,3,0,0,0,0,0,101
1152025,46,7,0,0,0,3,0,56
1152026,33,5,0,3,0,0,0,41
1152101,0,0,0,0,0,0,0,0
1152201,85,5,0,0,0,0,0,90
1152202,53,8,0,0,0,0,0,61
1152203,0,0,0,0,0,0,0,0
1152204,78,3,7,3,0,0,0,91
1152205,0,0,0,0,0,0,0,0
1152206,61,0,6,0,0,0,0,67
1152207,56,3,0,0,0,0,0,59
1152208,55,4,0,0,0,0,0,59
1152209,37,0,3,0,0,0,3,43
1152210,73,4,0,4,0,0,0,81
1152211,102,3,6,3,0,0,0,114
1152212,51,5,3,0,0,0,0,59
1152213,42,5,0,3,0,0,0,50
1152214,55,6,0,0,0,0,0,61
1152215,57,4,0,0,0,0,0,61
1152216,46,3,3,0,0,0,0,52
1152217,42,3,3,0,0,0,0,48
1152218,64,5,3,0,0,0,0,72
1152219,50,0,0,3,0,0,0,53
1152220,35,3,3,0,0,0,0,41
1152221,35,0,0,0,0,0,0,35
1152222,68,4,0,0,0,0,0,72
1152223,58,0,6,0,0,0,0,64
1152224,47,7,0,0,0,0,0,54
1152225,76,4,4,0,0,0,0,84
1152226,121,8,0,0,0,0,0,129
1152227,51,0,5,0,0,0,0,56
1152228,64,4,0,0,0,0,0,68
1152229,49,0,3,0,0,0,0,52
1152230,69,4,5,0,0,0,0,78
1152231,32,0,3,0,0,0,0,35
1152232,44,5,0,4,0,0,0,53
1152233,94,8,3,0,0,0,0,105
1152234,33,3,3,0,3,0,0,42
1152235,32,0,0,0,0,0,0,32
1152236,49,3,0,4,0,0,0,56
1152301,0,0,0,0,0,0,0,0
1152302,58,6,0,0,0,0,0,64
1152303,129,8,3,0,0,0,0,140
1152304,70,4,0,3,0,0,0,77
1152305,65,0,0,3,0,0,0,68
1152306,58,9,0,3,0,0,0,70
1152307,0,0,0,0,0,0,0,0
1152308,27,3,0,3,0,0,0,33
1152309,0,0,0,0,0,0,0,0
1152310,54,4,0,0,0,0,0,58
1152311,73,6,0,3,0,0,0,82
1152312,56,10,3,0,0,0,0,69
1152313,32,0,0,0,0,5,0,37
1152314,53,0,5,0,0,0,0,58
1152315,39,0,0,0,0,0,0,39
1152316,70,3,3,0,0,0,0,76
1152317,31,3,3,0,0,0,0,37
1152318,56,6,4,0,0,0,0,66
1152319,64,3,3,0,0,0,0,70
1152320,59,7,4,3,0,0,0,73
1152321,80,3,3,3,0,0,0,89
1152322,44,0,3,0,0,0,3,50
1152323,41,3,0,0,0,0,0,44
1152324,18,3,3,0,0,0,0,24
1152325,3,0,0,0,0,0,0,3
1152326,74,8,0,0,0,0,0,82
1152327,58,0,0,6,0,0,0,64
1152328,45,8,0,0,0,0,0,53
1152329,90,8,0,0,0,0,0,98
1152330,31,3,0,3,0,0,0,37
1152331,56,3,3,0,0,0,0,62
1152332,50,8,3,0,0,0,0,61
1152333,0,0,0,0,0,0,0,0
1152334,46,3,0,0,0,0,0,49
1152335,36,0,0,0,0,0,0,36
1152336,62,7,0,0,0,0,0,69
1152337,29,3,3,0,0,0,0,35
1152338,38,3,3,3,0,0,0,47
1152339,47,9,3,0,0,0,0,59
1152340,49,4,3,3,0,0,0,59
1152341,16,0,0,0,0,0,0,16
1152342,0,0,0,0,0,0,0,0
1152343,101,4,5,0,0,0,0,110
1152344,24,3,0,0,0,0,0,27
1152401,54,5,0,0,0,0,0,59
1152402,66,3,3,0,0,0,0,72
1152403,38,0,0,0,0,0,0,38
1152404,80,3,3,3,0,0,0,89
1152405,70,4,0,0,0,0,0,74
1152406,67,0,0,0,0,0,0,67
1152407,60,5,3,0,0,0,0,68
1152408,60,0,3,0,0,0,3,66
1152409,59,4,3,0,0,0,0,66
1152410,42,6,0,0,0,0,0,48
1152411,43,3,3,3,0,0,0,52
1152412,104,9,3,0,0,0,0,116
1152413,92,4,4,0,0,0,0,100
1152414,44,0,4,0,0,0,0,48
1152415,56,3,0,0,0,0,0,59
1152416,53,0,4,0,0,0,0,57
1152417,59,4,3,0,0,0,0,66
1152418,105,3,8,3,0,0,0,119
1152419,90,3,3,0,0,0,0,96
1152420,42,0,3,0,0,0,0,45
1152421,97,3,3,0,0,0,0,103
1152422,49,0,0,0,0,0,0,49
1152423,87,0,4,0,0,0,0,91
1152424,59,0,3,0,0,0,0,62
1152425,74,9,3,3,0,0,0,89
1152426,53,3,4,0,0,0,0,60
1152427,72,10,3,0,0,0,0,85
1152428,56,4,4,0,0,0,0,64
1152429,48,4,3,0,0,0,0,55
1152430,55,4,3,0,0,0,0,62
1152431,0,0,0,0,0,0,0,0
1152432,43,0,6,0,0,0,0,49
1152433,50,5,3,0,0,0,0,58
1152434,0,0,0,0,0,0,0,0
1152435,90,5,3,0,0,0,0,98
1152436,45,5,0,0,0,0,0,50
1152437,0,0,0,0,0,0,0,0
1152438,68,4,0,0,0,0,0,72
1152439,50,4,0,0,0,0,0,54
1152440,125,3,3,0,0,0,0,131
1152441,55,5,4,0,0,0,0,64
1152442,0,0,0,0,0,0,0,0
1152443,53,3,3,0,0,0,0,59
1152444,43,9,3,0,0,0,0,55
1152445,59,5,3,0,0,0,0,67
1152446,34,6,0,0,0,0,0,40
1152447,68,3,3,0,0,0,0,74
1152448,75,0,3,4,0,0,0,82
1152449,22,0,3,0,0,0,0,25
1152450,46,0,3,0,0,0,3,52
1152501,46,3,0,0,0,0,0,49
1152502,21,3,0,0,0,0,3,27
1152503,33,3,0,0,0,0,0,36
1152504,75,0,3,0,0,0,0,78
1152505,37,4,0,0,0,0,0,41
1152506,61,4,0,0,0,0,0,65
1152507,62,4,3,0,0,0,0,69
1152508,48,3,3,3,0,0,0,57
1152509,72,3,3,3,0,0,0,81
1152510,69,9,0,3,0,0,0,81
1152511,28,0,0,4,0,0,0,32
1152512,51,3,0,0,3,0,0,57
1152513,55,3,0,0,0,0,0,58
1152514,55,3,3,0,0,0,0,61
1152515,46,3,0,3,0,0,0,52
1152516,58,6,0,0,0,0,0,64
1152517,58,3,5,0,0,0,0,66
1152518,107,0,10,4,0,0,0,121
1152519,37,4,0,0,0,0,0,41
1152520,53,4,0,0,0,0,0,57
1152521,67,3,0,0,0,0,0,70
1152522,49,3,3,3,0,0,0,58
1152523,66,0,3,0,0,0,0,69
1152524,46,3,0,0,0,0,0,49
1152525,60,0,4,0,0,0,0,64
1152526,66,0,4,4,0,0,0,74
1152527,40,3,0,0,0,0,0,43
1152528,55,3,3,0,0,0,3,64
1152529,33,3,3,0,0,0,0,39
1152530,37,5,0,0,0,0,0,42
1152531,56,4,0,0,0,0,0,60
1152532,33,0,0,5,0,0,0,38
1152533,47,5,0,0,0,0,0,52
1152534,25,0,3,3,0,0,0,31
1152535,34,4,0,0,0,0,0,38
1152536,50,0,0,3,0,0,3,56
1152537,53,0,0,0,0,0,0,53
1152538,35,5,0,0,0,0,0,40
1152539,80,0,3,3,0,0,0,86
1152540,31,0,0,0,0,0,0,31
1152541,63,3,3,3,3,0,0,75
1152542,0,3,0,0,0,0,0,3
1152543,29,3,3,0,0,0,0,35
1152544,29,3,0,0,0,0,0,32
1152545,47,0,0,0,0,0,0,47
1152546,75,0,0,0,0,0,4,79
1152547,57,6,0,3,3,0,0,69
1152548,51,4,0,0,0,0,0,55
1152549,72,3,3,0,0,0,0,78
1152550,0,0,0,0,0,0,0,0
1152551,17,3,3,0,0,0,0,23
1152552,20,0,3,0,0,0,0,23
1152553,83,3,0,0,0,0,0,86
1152554,52,7,3,3,0,0,0,65
1152555,73,3,0,0,0,0,0,76
1152556,52,0,3,0,0,0,0,55
1152557,38,3,0,0,0,0,0,41
1152558,66,3,0,0,0,0,3,72
1152559,47,3,0,0,0,0,0,50
1152560,47,0,0,0,3,0,0,50
1152561,0,0,0,0,0,0,0,0
1152562,54,7,3,0,0,0,0,64
1152563,71,3,0,0,0,0,0,74
1152564,55,8,0,3,0,0,0,66
1152601,73,4,8,0,0,0,0,85
1152602,55,5,3,0,0,0,0,63
1152603,49,3,0,0,0,0,3,55
1152604,28,0,0,0,0,0,0,28
1152605,39,3,3,0,0,0,3,48
1152606,24,3,0,0,0,0,0,27
1152607,75,5,3,0,0,0,0,83
1152608,36,4,0,0,0,0,0,40
1152609,53,4,5,0,0,0,0,62
1152610,95,3,7,3,0,0,0,108
1152611,57,3,3,0,0,0,0,63
1152612,64,3,3,0,0,0,0,70
1152613,48,3,3,3,0,0,0,57
1152614,74,3,3,3,0,0,0,83
1152615,70,8,0,0,0,0,0,78
1152616,80,4,3,4,0,0,0,91
1152617,34,3,3,0,0,0,0,40
1152618,92,3,3,0,0,0,0,98
1152619,67,3,3,0,0,0,0,73
1152620,10,0,0,0,0,0,0,10
1152621,0,0,0,0,0,0,0,0
1152622,27,0,0,4,0,0,0,31
1152623,29,0,0,0,0,0,0,29
1152624,31,3,0,3,0,0,3,40
1152625,41,5,3,0,3,0,0,52
1152626,57,0,7,0,0,0,0,64
1152627,50,3,0,0,0,0,0,53
1152628,55,0,0,0,0,0,0,55
1152629,55,4,3,0,0,0,0,62
1152630,46,3,3,4,0,0,0,56
1152631,54,3,0,0,0,0,0,57
1152632,65,3,3,3,0,0,0,74
1152633,95,5,4,0,0,0,4,108
1152634,51,0,0,0,0,0,0,51
1152635,19,3,3,3,0,0,0,28
1152636,53,8,3,3,0,0,0,67
1152637,35,3,3,0,0,3,0,44
1152638,59,3,6,0,0,0,0,68
1152639,29,0,0,0,0,0,0,29
1152640,47,0,3,0,0,0,0,50
1152641,123,6,0,0,0,0,0,129
1152642,50,0,3,0,0,0,0,53
1152643,26,0,3,0,0,0,0,29
1152644,83,3,0,3,0,0,0,89
1152645,37,4,3,0,0,0,0,44
1152646,125,3,4,3,0,0,0,135
1152647,81,0,0,0,0,4,0,85
1152648,56,3,0,0,0,0,0,59
1152649,61,0,0,0,0,0,0,61
1152650,133,3,3,0,0,0,0,139
1152651,50,4,3,0,0,0,0,57
1152652,83,3,3,0,0,0,0,89
1152653,127,3,11,8,0,0,0,149
1152654,82,0,5,0,0,0,0,87
1152655,138,0,8,0,0,0,0,146
1152656,84,4,5,0,0,0,0,93
1152657,79,0,3,5,0,0,0,87
1152658,50,4,3,0,0,0,0,57
1152659,49,4,3,0,0,0,0,56
1152701,43,0,0,0,0,0,0,43
1152702,58,3,0,0,0,0,0,61
1152703,59,5,0,0,0,0,0,64
1152704,27,3,0,0,0,0,0,30
1152705,41,0,3,0,0,0,0,44
1152706,36,7,0,0,0,0,3,46
1152707,39,4,0,0,0,0,0,43
1152708,56,6,0,0,0,0,0,62
1152709,45,3,0,0,0,0,0,48
1152710,36,0,3,0,0,0,0,39
1152711,43,5,0,0,0,0,0,48
1152712,62,4,3,0,0,0,0,69
1152713,37,3,0,0,0,0,0,40
1152714,58,3,3,4,0,0,0,68
1152715,0,0,0,0,0,0,0,0
1152716,82,3,0,3,0,0,0,88
1152717,0,0,0,0,0,0,0,0
1152718,15,0,0,0,0,0,0,15
1152719,45,0,0,0,0,0,0,45
1152720,41,4,6,0,0,0,0,51
1152721,37,3,0,0,0,0,0,40
1152722,69,3,3,0,0,0,0,75
1152723,34,4,0,0,0,0,0,38
1152724,41,3,3,3,0,0,0,50
1152725,77,6,3,0,0,0,0,86
1152726,56,3,0,0,0,0,0,59
1152727,62,0,3,0,0,0,0,65
1152728,49,3,3,0,0,0,0,55
1152729,62,0,3,0,0,0,0,65
1152730,52,9,4,3,0,0,0,68
1152731,61,3,0,0,0,0,0,64
1152732,56,0,0,0,0,0,0,56
1152733,89,9,3,4,0,0,0,105
1152734,62,3,3,0,0,0,0,68
1152735,59,3,4,3,0,0,0,69
1152736,70,5,5,0,0,0,0,80
1152737,60,3,0,0,0,0,0,63
1152738,63,3,3,3,0,0,0,72
1152739,52,3,0,0,0,0,0,55
1152740,60,3,0,0,0,0,0,63
1152741,59,0,0,0,0,0,0,59
1152742,73,4,3,0,0,0,0,80
1152743,50,0,0,0,0,0,0,50
1152744,67,5,4,0,0,0,0,76
1152745,47,4,0,0,0,0,0,51
1152746,47,7,0,0,0,0,0,54
1152747,71,4,4,0,0,0,0,79
1152748,68,0,4,0,0,0,0,72
1152749,71,3,3,0,0,0,0,77
1152750,42,3,3,0,0,0,0,48
1152751,35,3,0,0,0,0,0,38
1152752,45,4,3,0,0,0,0,52
1152753,43,0,0,0,0,0,3,46
1152754,27,3,4,0,0,0,0,34
1152755,24,5,0,0,0,0,0,29
1152756,49,6,0,0,0,0,0,55
1152757,23,0,0,0,0,0,0,23
1152758,44,4,0,0,0,0,0,48
1152759,73,3,0,0,0,0,3,79
1152760,79,0,5,0,0,0,0,84
1152761,29,3,3,0,0,0,0,35
1152762,56,4,4,0,0,0,0,64
1152763,3,0,0,0,0,0,3,6
1152764,41,4,0,0,0,0,0,45
1152801,18,3,0,0,0,0,0,21
1152802,21,3,0,0,0,0,0,24
1152803,37,6,0,0,0,0,0,43
1152804,46,3,4,0,0,0,0,53
1152805,64,5,5,0,0,0,0,74
1152806,0,0,0,0,0,0,0,0
1152807,14,3,3,0,0,0,0,20
1152808,12,0,0,0,0,0,0,12
1152809,29,3,0,0,0,0,0,32
1152810,49,0,0,0,0,0,0,49
1152811,37,0,0,0,0,0,0,37
1152812,32,3,0,0,0,0,0,35
1152813,41,3,0,0,0,0,0,44
1152814,0,0,0,0,0,0,0,0
1152815,0,0,0,0,0,0,0,0
1152816,0,0,0,0,0,0,0,0
1152817,46,0,4,0,0,0,0,50
1152818,23,3,0,0,0,0,0,26
1152819,47,6,0,0,0,0,0,53
1152820,7,0,3,0,0,0,0,10
1152821,107,8,4,0,0,0,0,119
1152822,29,3,3,0,0,0,0,35
1152823,22,0,0,0,0,0,0,22
1152824,20,0,0,0,0,0,0,20
1152825,12,0,0,0,0,0,0,12
1152826,16,4,0,0,0,0,0,20
1152827,68,0,0,0,0,0,0,68
1152828,33,3,0,0,0,0,0,36
1152829,48,0,0,0,0,0,0,48
1152830,30,4,3,0,0,0,0,37
1152831,49,0,0,0,0,0,0,49
1152832,11,0,0,0,0,0,0,11
1152833,31,0,0,0,0,0,0,31
1152834,45,3,5,0,0,0,0,53
1152835,7,4,0,0,0,0,0,11
1152836,12,3,3,0,0,0,0,18
1152837,36,4,0,0,0,0,0,40
1152838,46,5,0,0,0,0,0,51
1152839,24,3,0,0,0,0,0,27
1152840,16,0,3,0,0,0,0,19
1152841,47,3,3,0,0,0,0,53
1152842,46,3,3,0,0,0,0,52
1152843,34,3,0,0,0,0,0,37
1152844,66,0,3,0,0,0,0,69
1152845,45,0,0,3,0,0,0,48
1152846,76,6,4,0,0,0,3,89
1152847,44,0,0,4,0,0,0,48
1152848,36,5,4,0,0,0,0,45
1152849,0,0,0,0,0,0,0,0
1152850,75,0,0,0,0,0,0,75
1152851,51,3,3,0,0,0,0,57
1152852,57,3,3,0,0,0,0,63
1152853,32,0,0,0,0,0,0,32
1152854,24,3,0,0,0,0,0,27
1152855,12,3,0,0,0,0,0,15
1152856,31,4,0,0,0,0,0,35
1152857,75,3,3,0,0,0,0,81
1152858,48,0,0,0,0,0,0,48
1152859,90,3,3,3,0,0,0,99
1152860,16,0,0,0,0,0,0,16
1152861,0,0,0,0,0,0,0,0
1152862,0,0,0,0,0,0,0,0
1152863,55,7,0,0,0,0,0,62
1152864,74,4,0,0,0,0,0,78
1152865,37,3,0,0,0,0,0,40
1152866,38,3,4,0,0,0,0,45
1152867,49,7,0,0,0,0,0,56
1152868,81,3,0,0,0,0,0,84
1152869,61,4,0,0,0,0,0,65
1152870,19,3,3,0,0,0,0,25
1152871,13,4,0,0,0,0,0,17
1152872,17,5,0,0,0,0,0,22
1152873,53,0,0,0,0,0,0,53
1152874,44,6,3,0,0,0,3,56
1152875,33,7,3,0,0,0,0,43
1152876,34,7,0,0,0,0,0,41
1152877,72,5,0,0,0,0,0,77
1152878,46,0,3,0,0,0,0,49
1152879,24,3,0,0,0,0,0,27
1152880,21,3,0,0,0,0,0,24
1152881,30,4,0,0,0,0,0,34
1152882,17,6,0,0,0,0,0,23
1152883,5,0,0,0,0,0,0,5
1152884,20,0,3,0,0,0,0,23
1152901,45,4,0,0,0,0,0,49
1152902,71,3,3,0,0,0,0,77
1152903,68,3,3,3,0,0,0,77
1152904,83,9,0,0,0,0,0,92
1152905,48,7,3,0,0,0,0,58
1152906,62,3,5,0,0,0,0,70
1152907,51,6,0,0,0,0,0,57
1152908,113,9,0,0,0,0,0,122
1152909,45,4,4,0,0,0,0,53
1152910,55,3,3,0,0,0,0,61
1152911,69,3,3,0,0,0,0,75
1152912,89,3,0,0,0,0,0,92
1152913,30,0,3,0,0,0,0,33
1152914,57,0,3,0,0,0,0,60
1152915,23,6,4,0,0,0,0,33
1152916,53,3,3,0,0,0,0,59
1152917,56,3,0,0,0,0,0,59
1152918,37,8,0,0,0,0,0,45
1152919,49,5,0,0,0,0,0,54
1152920,15,3,0,0,0,0,0,18
1152921,21,5,4,0,0,0,0,30
1152922,50,0,3,0,0,0,0,53
1152923,44,3,3,0,0,0,0,50
1152924,35,0,0,0,0,0,0,35
1152925,31,0,0,5,0,0,0,36
1152926,33,8,0,0,0,0,0,41
1152927,60,4,4,0,0,0,0,68
1152928,59,4,3,0,0,0,0,66
1152929,60,3,0,0,0,0,0,63
1152930,70,3,0,0,0,0,0,73
1152931,64,3,3,0,0,0,0,70
1152932,87,4,0,0,0,0,0,91
1152933,44,3,0,0,0,0,0,47
1152934,84,0,3,0,0,0,0,87
1152935,70,10,0,0,0,0,0,80
1152936,59,5,0,0,0,0,0,64
1152937,69,6,0,0,0,0,0,75
1152938,65,8,0,0,0,0,0,73
1152939,46,3,3,0,0,0,0,52
1152940,89,6,0,3,0,0,0,98
1153001,60,3,0,0,0,0,0,63
1153002,37,3,3,0,3,0,3,49
1153003,62,7,0,0,0,0,0,69
1153004,26,3,3,0,0,0,0,32
1153005,16,3,0,0,0,0,0,19
1153006,57,3,0,0,0,0,0,60
1153007,61,3,0,0,0,0,0,64
1153008,89,4,0,0,0,0,0,93
1153009,45,0,4,0,0,0,0,49
1153010,73,0,3,0,0,0,3,79
1153011,69,0,3,0,0,0,0,72
1153012,46,3,3,0,0,0,0,52
1153013,30,3,0,0,0,0,3,36
1153014,42,0,0,0,0,0,0,42
1153015,40,5,0,0,0,0,0,45
1153016,50,3,3,0,0,0,0,56
1153017,37,4,0,0,0,0,0,41
1153018,62,4,3,0,0,0,0,69
1153019,46,0,0,0,0,0,0,46
1153020,22,0,0,0,0,0,0,22
1153021,41,3,3,0,0,0,0,47
1153022,64,3,3,0,0,0,0,70
1153023,66,3,0,0,0,0,0,69
1153024,52,5,4,0,0,0,0,61
1153025,45,3,3,0,0,0,0,51
1153026,20,0,0,0,0,0,0,20
1153027,39,3,0,0,0,0,0,42
1153028,70,3,3,0,0,0,0,76
1153029,87,3,4,0,0,0,0,94
1153030,13,0,0,0,0,0,0,13
1153031,51,0,3,0,0,0,0,54
1153032,27,7,3,0,0,0,0,37
1153033,29,3,3,0,0,0,0,35
1153034,51,3,5,3,0,0,0,62
1153035,30,4,3,0,0,0,0,37
1153036,83,0,3,0,0,0,0,86
1153037,67,3,3,0,0,0,0,73
1153038,48,5,3,3,0,0,0,59
1153039,51,3,3,0,0,0,3,60
1153040,48,3,0,0,0,0,0,51
1153101,0,0,0,0,0,0,0,0
1153102,0,0,0,0,0,0,0,0
1153103,52,4,0,3,0,0,0,59
1153104,27,3,3,0,0,0,0,33
1153105,58,4,3,0,0,0,0,65
1153106,32,3,0,0,0,0,0,35
1153107,45,3,0,0,0,0,0,48
1153108,21,4,3,0,0,0,0,28
1153109,45,3,0,0,0,0,0,48
1153110,82,4,3,0,0,0,0,89
1153111,55,0,0,0,0,0,0,55
1153112,20,3,0,0,0,0,0,23
1153113,78,10,0,0,0,0,0,88
1153114,47,3,3,0,0,0,0,53
1153115,85,8,4,0,0,0,0,97
1153116,56,3,0,0,0,0,0,59
1153117,78,0,5,0,0,0,0,83
1153118,68,3,0,0,0,0,0,71
1153119,37,3,3,0,0,0,0,43
1153120,60,0,0,0,0,0,0,60
1153121,63,6,0,0,0,0,0,69
1153122,57,4,0,0,0,0,0,61
1153123,39,0,3,0,0,0,0,42
1153124,55,0,0,0,0,0,0,55
1153125,53,3,3,0,0,0,0,59
1153126,56,0,3,0,0,0,0,59
1153127,57,3,0,0,0,0,0,60
1153128,32,5,5,0,0,0,0,42
1153129,38,3,3,0,0,0,0,44
1153130,56,0,3,0,0,0,0,59
1153131,63,3,0,0,0,0,0,66
1153132,45,3,0,0,0,0,0,48
1153133,39,0,0,0,0,0,0,39
1153134,63,3,0,0,0,0,0,66
1153135,56,5,0,0,0,0,0,61
1153136,40,4,3,0,0,0,0,47
1153137,43,3,3,0,0,3,0,52
1153201,66,3,3,0,0,0,0,72
1153202,84,0,3,0,0,0,0,87
1153203,58,3,3,0,0,0,0,64
1153204,53,3,3,0,0,0,0,59
1153205,69,3,0,0,0,0,0,72
1153206,49,3,3,0,0,0,0,55
1153207,59,3,4,0,0,0,0,66
1153208,0,0,0,0,0,0,0,0
1153209,67,6,0,0,0,0,0,73
1153210,0,0,0,0,0,0,0,0
1153211,20,5,3,0,0,0,0,28
1153212,36,3,0,0,0,0,0,39
1153213,24,0,5,0,0,0,0,29
1153214,32,0,0,0,0,0,0,32
1153215,22,3,3,0,0,0,0,28
1153216,54,0,4,4,0,0,0,62
1153217,44,5,4,0,0,0,0,53
1153218,55,7,3,3,0,0,0,68
1153219,45,0,3,0,0,0,0,48
1153220,77,3,8,0,0,0,0,88
1153221,79,8,0,0,0,0,0,87
1153222,35,0,0,0,0,0,0,35
1153223,37,3,4,0,0,0,0,44
1153224,28,3,0,0,0,0,0,31
1153225,95,4,4,3,0,0,0,106
1153226,78,5,5,0,0,0,0,88
1153227,45,0,3,0,0,0,0,48
1153228,85,5,0,0,0,0,0,90
1153229,0,0,0,0,0,0,0,0
1153230,56,4,4,0,0,0,0,64
1153231,61,4,0,4,0,0,0,69
1153232,88,0,3,0,0,0,0,91
1153233,0,0,0,0,0,0,0,0
1153234,98,3,0,0,0,0,0,101
1153235,48,3,0,0,0,0,0,51
1153236,79,4,0,0,0,0,0,83
1153237,38,3,3,0,0,0,0,44
1153238,83,3,0,0,0,0,0,86
1153239,89,3,3,3,0,0,0,98
1153240,63,5,0,0,0,0,0,68
1153241,65,3,0,0,0,0,0,68
1153242,78,7,3,0,0,0,0,88
1153243,99,3,3,0,0,0,0,105
1153244,63,6,0,3,0,0,0,72
1153245,64,0,0,0,0,0,0,64
1153246,68,8,4,0,0,0,0,80
1153247,91,5,7,0,0,0,0,103
1153248,84,6,0,0,0,0,0,90
1153249,115,6,0,0,0,0,0,121
1153250,70,8,3,0,0,0,0,81
1153251,51,3,0,3,0,0,0,57
1153252,87,6,0,0,0,0,0,93
1153253,64,3,3,0,0,0,0,70
1153254,44,3,0,0,0,0,0,47
1153255,69,3,3,0,0,0,0,75
1153256,35,4,0,0,0,0,0,39
1153257,66,5,0,0,0,0,0,71
1153258,56,7,0,0,0,0,0,63
1153259,64,4,4,0,0,0,0,72
1153260,48,3,3,0,0,0,0,54
1153261,73,7,5,0,0,0,0,85
1153262,85,0,3,0,0,0,0,88
1153263,78,4,0,4,0,0,0,86
1153264,65,0,0,0,0,0,0,65
1153265,65,0,0,0,0,0,3,68
1153266,101,7,0,0,0,0,0,108
1153267,46,0,4,3,0,0,0,53
1153268,67,6,0,0,0,0,0,73
1153301,41,0,3,0,0,0,0,44
1153302,50,3,3,0,0,0,0,56
1153303,85,0,3,0,0,0,0,88
1153304,4,0,0,0,0,0,0,4
1153305,66,3,3,3,0,0,0,75
1153306,47,6,3,0,0,0,0,56
1153307,27,4,0,0,0,0,0,31
1153308,85,0,3,0,0,0,3,91
1153309,78,7,4,0,0,0,0,89
1153310,38,3,0,0,0,0,3,44
1153311,44,7,3,0,0,0,0,54
1153312,58,0,3,0,0,0,0,61
1153313,39,0,0,0,0,0,0,39
1153314,56,10,0,0,0,0,0,66
1153315,36,4,0,0,0,0,0,40
1153316,47,9,0,0,0,0,0,56
1153317,45,5,0,0,0,0,0,50
1153318,38,5,0,0,0,0,0,43
1153401,61,8,0,0,0,0,0,69
1153402,0,0,0,0,0,0,0,0
1153403,63,3,0,0,0,0,0,66
1153404,70,3,4,3,0,0,0,80
1153405,58,7,3,3,0,0,0,71
1153406,76,0,0,0,0,0,0,76
1153407,36,0,0,0,0,0,0,36
1153408,78,7,3,0,0,0,0,88
1153409,81,4,0,0,0,0,0,85
1153410,27,4,0,0,0,0,0,31
1153411,51,0,3,0,0,0,0,54
1153412,68,4,0,0,0,0,0,72
1153413,39,0,0,0,0,0,0,39
1153414,75,4,4,0,0,0,0,83
1153415,59,0,0,0,0,0,0,59
1153416,76,0,5,0,0,0,0,81
1153417,0,0,0,0,0,0,0,0
1153418,36,0,0,0,0,0,0,36
1153419,75,4,4,0,0,0,0,83
1153420,87,0,3,0,0,0,0,90
1153421,0,0,0,0,0,0,0,0
1153422,44,3,3,0,0,0,0,50
1153423,81,0,0,0,0,0,0,81
1153424,104,4,3,0,0,0,0,111
1153425,61,0,3,0,0,0,0,64
1153426,47,9,0,0,0,0,0,56
1153427,48,0,3,0,0,0,0,51
1153428,35,3,0,0,3,0,0,41
1153429,47,0,0,3,0,0,3,53
1153430,52,0,0,0,0,0,0,52
1153431,48,0,3,0,0,0,0,51
1153432,68,3,3,0,0,0,0,74
1153501,62,4,0,0,0,0,0,66
1153502,79,8,3,3,0,0,0,93
1153503,59,6,0,0,0,0,0,65
1153504,72,7,5,4,0,0,0,88
1153505,0,0,0,0,0,0,0,0
1153506,104,3,6,0,0,0,3,116
1153507,80,0,5,0,0,0,0,85
1153508,36,6,0,0,0,0,0,42
1153509,59,0,3,0,0,0,0,62
1153510,59,0,5,0,0,0,0,64
1153511,45,3,0,0,0,0,0,48
1153512,71,0,7,0,0,0,0,78
1153513,91,6,4,0,0,0,0,101
1153514,41,7,7,3,0,0,0,58
1153515,49,10,3,0,0,0,0,62
1153516,0,0,0,0,0,0,0,0
1153517,0,0,0,0,0,0,0,0
1153518,65,8,0,0,0,0,0,73
1153519,101,0,5,0,0,0,0,106
1153520,13,0,3,0,0,0,0,16
1153521,55,4,0,0,0,0,3,62
1153522,77,8,3,0,0,0,0,88
1153523,62,3,4,3,0,0,0,72
1153524,46,4,0,0,0,0,0,50
1153525,100,4,0,0,0,0,0,104
1153526,76,4,3,0,0,0,0,83
1153527,56,3,0,0,0,0,0,59
1153528,34,6,0,0,0,0,0,40
1153529,69,3,4,0,0,0,0,76
1153530,78,7,3,0,0,0,0,88
1153531,42,3,3,0,0,0,0,48
1153532,98,6,3,0,0,0,0,107
1153533,28,0,0,0,0,0,0,28
1153534,70,4,4,0,0,0,0,78
1153535,56,3,0,3,0,0,0,62
1153536,77,8,0,0,0,0,0,85
1153537,0,0,0,0,0,0,0,0
1153538,27,0,0,0,0,0,0,27
1153539,14,0,3,0,0,0,0,17
1153540,32,0,0,0,0,0,0,32
1153541,51,4,4,3,0,0,0,62
1153542,69,0,3,0,0,0,0,72
1153543,79,3,3,3,0,0,0,88
1153544,74,0,0,3,0,0,0,77
1153545,70,3,0,0,0,0,0,73
1153546,34,4,0,0,0,0,0,38
1153547,72,8,0,0,0,0,0,80
1153548,45,3,0,3,0,0,0,51
1153549,46,3,0,0,0,0,0,49
1153550,71,6,0,0,0,0,0,77
1153551,55,4,5,0,0,0,0,64
1153552,44,4,3,0,0,0,0,51
1153553,48,7,4,0,0,0,0,59
1153554,71,4,4,0,0,0,0,79
1153555,60,7,0,0,0,0,0,67
1153556,47,5,0,0,0,0,0,52
1153557,44,3,3,0,0,0,0,50
1153601,25,0,3,0,0,0,0,28
1153602,55,0,5,0,0,0,0,60
1153603,39,0,0,0,0,0,0,39
1153604,48,0,3,0,0,0,0,51
1153605,52,3,0,0,0,0,0,55
1153606,52,7,3,0,0,0,0,62
1153607,48,0,3,0,0,0,0,51
1153608,41,4,0,3,0,0,0,48
1153609,62,3,3,0,0,0,0,68
1153610,103,5,0,0,0,0,0,108
1153611,78,5,0,0,0,0,0,83
1153612,38,0,0,0,0,0,0,38
1153613,40,0,0,0,0,0,0,40
1153614,50,0,0,3,0,0,0,53
1153615,31,3,0,0,0,0,0,34
1153616,58,0,0,0,0,0,0,58
1153617,84,6,0,3,0,0,0,93
1153618,42,4,3,0,0,0,0,49
1153619,47,0,3,0,0,0,0,50
1153620,91,4,3,0,0,0,3,101
1153621,83,3,0,0,0,0,3,89
1153622,109,3,0,0,0,0,0,112
1153623,50,3,0,0,0,0,0,53
1153624,85,3,0,0,0,0,0,88
1153625,75,3,3,3,0,0,0,84
1153626,64,0,0,0,0,0,0,64
1153627,31,6,0,0,0,0,0,37
1153628,50,3,0,0,0,0,0,53
1153629,49,3,0,0,0,0,0,52
1153630,52,0,0,0,0,0,0,52
1153631,84,3,0,3,0,4,0,94
1153632,57,3,3,0,0,0,0,63
1153633,75,0,4,0,0,0,0,79
1153634,68,3,3,0,0,0,0,74
1153635,39,5,0,0,0,0,0,44
1153636,54,4,0,0,0,0,0,58
1153637,72,0,0,0,0,0,0,72
1153638,81,3,3,0,0,0,0,87
1153639,54,3,3,0,0,0,0,60
1153640,54,8,3,0,0,0,0,65
1153641,57,4,0,0,0,0,0,61
1153642,72,11,0,0,0,0,0,83
1153643,69,6,0,5,0,0,0,80
1153644,73,0,0,0,0,0,0,73
1153645,75,4,0,0,0,0,0,79
1153646,55,6,0,0,0,0,0,61
1153647,83,3,3,3,0,0,0,92
1153648,47,5,4,0,0,0,0,56
1153649,67,3,0,0,0,0,0,70
1153701,0,0,0,0,0,0,0,0
1153801,48,7,3,0,0,0,0,58
1153802,40,0,3,0,0,0,0,43
1153803,67,7,0,0,0,0,0,74
1153804,23,6,3,0,0,0,0,32
1153805,0,0,0,0,0,0,0,0
1153806,49,0,0,0,0,0,0,49
1153807,0,0,0,0,0,0,0,0
1153808,48,7,3,0,0,0,3,61
1153809,28,0,0,0,0,0,0,28
1153810,39,3,3,0,0,0,0,45
1153811,0,0,0,0,0,0,0,0
1153812,32,3,5,0,0,3,0,43
1153813,35,3,0,0,0,0,0,38
1153814,37,5,3,0,0,0,0,45
1153815,51,3,4,0,0,0,0,58
1153816,26,3,3,0,0,0,0,32
1153817,34,0,5,0,0,0,0,39
1153818,0,0,0,0,0,0,0,0
1153819,0,0,0,0,0,0,0,0
1153820,17,3,0,0,0,0,0,20
1153821,58,0,0,0,0,0,0,58
1153822,37,0,3,0,0,0,0,40
1153823,74,4,0,0,0,0,0,78
1153824,0,0,0,0,0,0,0,0
1153825,14,0,4,0,0,0,0,18
1153826,26,3,4,0,0,0,0,33
1153827,26,7,3,0,0,0,0,36
1153828,55,3,3,0,0,0,0,61
1153829,29,0,0,0,0,0,0,29
1153830,47,0,0,0,0,0,0,47
1153831,84,3,3,0,0,0,0,90
1153832,74,6,0,0,0,0,0,80
1153833,29,3,3,0,0,0,0,35
1153834,46,3,0,0,0,0,0,49
1153835,34,3,0,0,0,0,0,37
1153836,66,4,4,0,0,0,0,74
1153837,40,6,0,0,0,0,0,46
1153838,66,5,0,0,0,0,0,71
1153839,40,7,0,0,0,0,0,47
1153840,27,3,4,0,0,0,0,34
1153841,42,0,0,0,0,0,0,42
1153842,25,0,0,0,0,0,0,25
1153843,37,5,0,0,0,0,0,42
1153844,35,3,0,0,0,0,0,38
1153845,39,4,0,0,0,0,0,43
1153846,28,5,0,0,0,0,0,33
1153847,81,7,3,4,0,0,0,95
1153848,40,9,3,0,0,0,0,52
1153849,41,6,0,0,0,0,0,47
1153850,36,7,0,0,0,0,0,43
1153851,16,0,3,0,0,0,0,19
1153852,25,5,0,0,0,0,0,30
1153853,52,3,3,0,0,0,0,58
1949999,0,0,0,0,0,0,0,0
1979991,0,0,0,0,0,0,0,0
1979992,0,0,0,0,0,0,0,0
1979993,0,0,0,0,0,0,0,0
